STATE/UT,Year,CAUSE,Male upto 14 years,Male 15-29 years,Male 30-44 years,Male 45-59 years,Male 60 years and above,Total Male,Female upto 14 years,Female 15-29 years,Female 30-44 years,Female 45-59 years,Female 60 years and above,Total Female,Grand Total,shortCode
A & N ISLANDS,2001,Others (Please Specify),1,4,5,4,1,15,0,1,0,0,0,1,16,AN
A & N ISLANDS,2001,House Wife,0,0,0,0,0,0,0,21,9,5,3,38,38,AN
A & N ISLANDS,2001,Service (Government),0,3,10,7,0,20,0,0,0,0,0,0,20,AN
A & N ISLANDS,2001,Service (Private),0,14,7,9,2,32,0,0,0,0,0,0,32,AN
A & N ISLANDS,2001,Public Sector Undertaking,0,2,1,1,0,4,0,0,0,0,0,0,4,AN
A & N ISLANDS,2001,Student,1,2,0,0,0,3,2,9,0,0,0,11,14,AN
A & N ISLANDS,2001,Unemployed,0,0,0,0,0,0,0,0,0,0,0,0,0,AN
A & N ISLANDS,2001,Self-employed (Business activity),0,0,0,0,0,0,0,0,0,0,0,0,0,AN
A & N ISLANDS,2001,Professional Activity,0,0,0,0,0,0,0,0,0,0,0,0,0,AN
A & N ISLANDS,2001,Farming/Agriculture Activity,0,0,0,0,3,3,0,0,0,0,0,0,3,AN
A & N ISLANDS,2001,Retired Person,0,0,0,0,2,2,0,0,0,0,0,0,2,AN
A & N ISLANDS,2001,Total,2,25,23,21,8,79,2,31,9,5,3,50,129,AN
A & N ISLANDS,2001,Total Salaried,0,19,18,17,2,56,0,0,0,0,0,0,56,AN
A & N ISLANDS,2001,Total Self-employed,1,4,5,4,4,18,0,1,0,0,0,1,19,AN
ANDHRA PRADESH,2001,Others (Please Specify),61,703,759,668,203,2394,96,386,245,186,50,963,3357,AP
ANDHRA PRADESH,2001,House Wife,0,0,0,0,0,0,0,1132,811,397,104,2444,2444,AP
ANDHRA PRADESH,2001,Service (Government),0,34,57,44,0,135,0,23,22,9,7,61,196,AP
ANDHRA PRADESH,2001,Service (Private),1,250,275,138,10,674,5,43,24,28,6,106,780,AP
ANDHRA PRADESH,2001,Public Sector Undertaking,0,32,36,29,13,110,0,4,5,1,0,10,120,AP
ANDHRA PRADESH,2001,Student,56,202,19,18,0,295,46,115,5,9,0,175,470,AP
ANDHRA PRADESH,2001,Unemployed,1,230,206,94,12,543,1,57,12,8,0,78,621,AP
ANDHRA PRADESH,2001,Self-employed (Business activity),25,107,223,117,14,486,20,24,22,4,12,82,568,AP
ANDHRA PRADESH,2001,Professional Activity,13,118,157,80,22,390,5,22,4,10,0,41,431,AP
ANDHRA PRADESH,2001,Farming/Agriculture Activity,16,382,480,374,79,1331,12,65,46,45,10,178,1509,AP
ANDHRA PRADESH,2001,Retired Person,0,0,1,4,16,21,0,0,2,0,3,5,26,AP
ANDHRA PRADESH,2001,Total,173,2058,2213,1566,369,6379,185,1871,1198,697,192,4143,10522,AP
ANDHRA PRADESH,2001,Total Salaried,1,316,368,211,23,919,5,70,51,38,13,177,1096,AP
ANDHRA PRADESH,2001,Total Self-employed,83,906,1218,835,194,3236,75,323,226,137,38,799,4035,AP
ARUNACHAL PRADESH,2001,Others (Please Specify),0,0,0,0,0,0,0,0,0,0,0,0,0,AR
ARUNACHAL PRADESH,2001,House Wife,0,0,0,0,0,0,0,9,5,1,0,15,15,AR
ARUNACHAL PRADESH,2001,Service (Government),0,5,7,2,0,14,0,0,0,0,0,0,14,AR
ARUNACHAL PRADESH,2001,Service (Private),0,12,19,1,0,32,0,5,4,0,0,9,41,AR
ARUNACHAL PRADESH,2001,Public Sector Undertaking,0,0,0,0,0,0,0,0,0,0,0,0,0,AR
ARUNACHAL PRADESH,2001,Student,0,2,0,0,0,2,2,4,0,0,0,6,8,AR
ARUNACHAL PRADESH,2001,Unemployed,0,2,1,0,0,3,0,0,0,0,0,0,3,AR
ARUNACHAL PRADESH,2001,Self-employed (Business activity),0,2,6,3,1,12,0,0,0,0,0,0,12,AR
ARUNACHAL PRADESH,2001,Professional Activity,0,0,0,0,0,0,0,0,0,0,0,0,0,AR
ARUNACHAL PRADESH,2001,Farming/Agriculture Activity,2,1,5,4,0,12,0,5,0,0,0,5,17,AR
ARUNACHAL PRADESH,2001,Retired Person,0,0,0,1,0,1,0,0,0,0,0,0,1,AR
ARUNACHAL PRADESH,2001,Total,2,24,38,11,1,76,2,23,9,1,0,35,111,AR
ARUNACHAL PRADESH,2001,Total Salaried,0,17,26,3,0,46,0,5,4,0,0,9,55,AR
ARUNACHAL PRADESH,2001,Total Self-employed,2,3,11,7,1,24,0,5,0,0,0,5,29,AR
ASSAM,2001,Others (Please Specify),6,229,287,192,29,743,10,116,66,29,8,229,972,AS
ASSAM,2001,House Wife,0,0,0,0,0,0,0,158,161,68,7,394,394,AS
ASSAM,2001,Service (Government),0,7,25,13,0,45,0,0,2,0,0,2,47,AS
ASSAM,2001,Service (Private),0,46,49,32,4,131,0,13,12,3,0,28,159,AS
ASSAM,2001,Public Sector Undertaking,0,39,28,17,0,84,0,0,2,0,0,2,86,AS
ASSAM,2001,Student,29,86,6,0,0,121,9,55,6,0,0,70,191,AS
ASSAM,2001,Unemployed,0,108,124,59,5,296,0,21,14,3,0,38,334,AS
ASSAM,2001,Self-employed (Business activity),0,59,85,45,10,199,0,12,5,7,0,24,223,AS
ASSAM,2001,Professional Activity,0,16,36,15,0,67,0,1,0,0,0,1,68,AS
ASSAM,2001,Farming/Agriculture Activity,0,30,62,43,9,144,0,7,6,9,1,23,167,AS
ASSAM,2001,Retired Person,0,0,0,2,4,6,0,0,0,0,0,0,6,AS
ASSAM,2001,Total,35,620,702,418,61,1836,19,383,274,119,16,811,2647,AS
ASSAM,2001,Total Salaried,0,92,102,62,4,260,0,13,16,3,0,32,292,AS
ASSAM,2001,Total Self-employed,1,234,356,226,30,847,5,96,47,28,2,178,1025,AS
BIHAR,2001,Others (Please Specify),4,49,69,18,11,151,5,56,27,11,5,104,255,BR
BIHAR,2001,House Wife,0,0,0,0,0,0,0,62,62,13,3,140,140,BR
BIHAR,2001,Service (Government),0,1,4,0,0,5,0,1,0,0,0,1,6,BR
BIHAR,2001,Service (Private),0,11,3,0,1,15,0,3,0,0,0,3,18,BR
BIHAR,2001,Public Sector Undertaking,0,0,1,0,0,1,0,0,0,0,0,0,1,BR
BIHAR,2001,Student,3,34,2,0,0,39,6,17,2,0,0,25,64,BR
BIHAR,2001,Unemployed,1,13,6,1,1,22,2,10,2,2,0,16,38,BR
BIHAR,2001,Self-employed (Business activity),0,2,12,0,0,14,1,0,0,0,0,1,15,BR
BIHAR,2001,Professional Activity,0,2,1,0,0,3,0,0,0,0,0,0,3,BR
BIHAR,2001,Farming/Agriculture Activity,0,19,23,12,1,55,0,4,1,1,0,6,61,BR
BIHAR,2001,Retired Person,0,0,0,0,2,2,0,0,0,0,0,0,2,BR
BIHAR,2001,Total,8,131,121,31,16,307,14,153,94,27,8,296,603,BR
BIHAR,2001,Total Salaried,0,12,8,0,1,21,0,4,0,0,0,4,25,BR
BIHAR,2001,Total Self-employed,3,45,43,13,2,106,1,11,8,1,0,21,127,BR
CHANDIGARH,2001,Others (Please Specify),0,9,10,1,1,21,0,5,5,0,0,10,31,CH
CHANDIGARH,2001,House Wife,0,0,0,0,0,0,0,11,6,2,0,19,19,CH
CHANDIGARH,2001,Service (Government),0,1,1,1,0,3,0,0,0,0,0,0,3,CH
CHANDIGARH,2001,Service (Private),0,4,4,0,0,8,0,0,0,0,0,0,8,CH
CHANDIGARH,2001,Public Sector Undertaking,0,0,0,0,0,0,0,0,0,0,0,0,0,CH
CHANDIGARH,2001,Student,0,4,0,0,0,4,0,2,0,0,0,2,6,CH
CHANDIGARH,2001,Unemployed,0,1,0,0,0,1,0,0,0,0,0,0,1,CH
CHANDIGARH,2001,Self-employed (Business activity),0,1,0,0,0,1,0,0,0,0,0,0,1,CH
CHANDIGARH,2001,Professional Activity,0,0,0,0,0,0,0,0,0,0,0,0,0,CH
CHANDIGARH,2001,Farming/Agriculture Activity,0,0,0,0,0,0,0,0,0,0,0,0,0,CH
CHANDIGARH,2001,Retired Person,0,0,0,0,1,1,0,0,0,0,0,0,1,CH
CHANDIGARH,2001,Total,0,20,15,2,2,39,0,18,11,2,0,31,70,CH
CHANDIGARH,2001,Total Salaried,0,5,5,1,0,11,0,0,0,0,0,0,11,CH
CHANDIGARH,2001,Total Self-employed,0,3,4,0,0,7,0,0,0,0,0,0,7,CH
CHHATTISGARH,2001,Others (Please Specify),18,198,245,167,87,715,17,148,106,65,40,376,1091,CG
CHHATTISGARH,2001,House Wife,0,0,0,0,0,0,3,301,202,74,26,606,606,CG
CHHATTISGARH,2001,Service (Government),0,11,36,15,1,63,0,4,2,1,0,7,70,CG
CHHATTISGARH,2001,Service (Private),0,47,81,33,6,167,1,6,2,1,0,10,177,CG
CHHATTISGARH,2001,Public Sector Undertaking,0,9,31,16,3,59,0,2,3,1,0,6,65,CG
CHHATTISGARH,2001,Student,17,100,17,0,0,134,23,69,3,0,0,95,229,CG
CHHATTISGARH,2001,Unemployed,0,100,69,17,7,193,0,19,6,0,0,25,218,CG
CHHATTISGARH,2001,Self-employed (Business activity),1,21,30,9,5,66,0,2,0,0,0,2,68,CG
CHHATTISGARH,2001,Professional Activity,0,12,14,4,2,32,0,2,2,0,0,4,36,CG
CHHATTISGARH,2001,Farming/Agriculture Activity,8,286,429,302,173,1198,5,81,92,51,25,254,1452,CG
CHHATTISGARH,2001,Retired Person,0,8,3,0,2,13,0,0,0,0,0,0,13,CG
CHHATTISGARH,2001,Total,44,792,955,563,286,2640,49,634,418,193,91,1385,4025,CG
CHHATTISGARH,2001,Total Salaried,0,67,148,64,10,289,1,12,7,3,0,23,312,CG
CHHATTISGARH,2001,Total Self-employed,19,452,615,421,233,1740,11,159,155,96,51,472,2212,CG
D & N HAVELI,2001,Others (Please Specify),0,0,0,3,0,3,0,0,1,1,0,2,5,DN
D & N HAVELI,2001,House Wife,0,0,0,0,0,0,1,9,3,0,0,13,13,DN
D & N HAVELI,2001,Service (Government),0,0,0,0,0,0,0,0,0,0,0,0,0,DN
D & N HAVELI,2001,Service (Private),0,1,3,1,0,5,0,0,0,0,0,0,5,DN
D & N HAVELI,2001,Public Sector Undertaking,0,0,0,0,0,0,0,0,0,0,0,0,0,DN
D & N HAVELI,2001,Student,0,0,0,0,0,0,0,0,0,0,0,0,0,DN
D & N HAVELI,2001,Unemployed,0,5,3,0,0,8,0,0,0,0,0,0,8,DN
D & N HAVELI,2001,Self-employed (Business activity),0,0,0,0,0,0,0,0,0,0,0,0,0,DN
D & N HAVELI,2001,Professional Activity,0,0,0,0,0,0,0,0,0,0,0,0,0,DN
D & N HAVELI,2001,Farming/Agriculture Activity,0,4,4,3,8,19,0,0,0,0,0,0,19,DN
D & N HAVELI,2001,Retired Person,0,0,0,0,0,0,0,0,0,0,0,0,0,DN
D & N HAVELI,2001,Total,0,10,10,7,8,35,1,9,4,1,0,15,50,DN
D & N HAVELI,2001,Total Salaried,0,1,3,1,0,5,0,0,0,0,0,0,5,DN
D & N HAVELI,2001,Total Self-employed,0,4,4,5,8,21,0,0,0,1,0,1,22,DN
DAMAN & DIU,2001,Others (Please Specify),0,2,2,0,0,4,0,0,0,0,0,0,4,DD
DAMAN & DIU,2001,House Wife,0,0,0,0,0,0,0,3,0,0,0,3,3,DD
DAMAN & DIU,2001,Service (Government),0,0,0,0,0,0,0,0,0,0,0,0,0,DD
DAMAN & DIU,2001,Service (Private),0,2,3,0,0,5,0,1,0,0,0,1,6,DD
DAMAN & DIU,2001,Public Sector Undertaking,0,0,0,0,0,0,0,0,0,0,0,0,0,DD
DAMAN & DIU,2001,Student,0,0,0,0,0,0,0,0,0,0,0,0,0,DD
DAMAN & DIU,2001,Unemployed,0,0,0,0,0,0,0,0,0,0,0,0,0,DD
DAMAN & DIU,2001,Self-employed (Business activity),0,0,0,0,0,0,0,0,0,0,0,0,0,DD
DAMAN & DIU,2001,Professional Activity,0,0,1,0,0,1,0,0,0,0,0,0,1,DD
DAMAN & DIU,2001,Farming/Agriculture Activity,0,0,0,0,0,0,0,0,0,0,0,0,0,DD
DAMAN & DIU,2001,Retired Person,0,0,0,0,0,0,0,0,0,0,0,0,0,DD
DAMAN & DIU,2001,Total,0,4,6,0,0,10,0,4,0,0,0,4,14,DD
DAMAN & DIU,2001,Total Salaried,0,2,3,0,0,5,0,1,0,0,0,1,6,DD
DAMAN & DIU,2001,Total Self-employed,0,1,3,0,0,4,0,0,0,0,0,0,4,DD
DELHI (UT),2001,Others (Please Specify),5,76,86,38,15,220,10,43,34,4,3,94,314,DL
DELHI (UT),2001,House Wife,0,0,0,0,0,0,0,174,118,27,8,327,327,DL
DELHI (UT),2001,Service (Government),0,11,13,5,0,29,0,1,1,0,0,2,31,DL
DELHI (UT),2001,Service (Private),0,68,51,27,1,147,0,12,1,0,0,13,160,DL
DELHI (UT),2001,Public Sector Undertaking,0,10,6,2,1,19,0,1,0,0,0,1,20,DL
DELHI (UT),2001,Student,9,42,4,0,0,55,14,35,0,0,0,49,104,DL
DELHI (UT),2001,Unemployed,1,91,76,34,7,209,4,13,3,0,0,20,229,DL
DELHI (UT),2001,Self-employed (Business activity),0,6,13,4,0,23,0,0,0,0,0,0,23,DL
DELHI (UT),2001,Professional Activity,0,3,4,4,0,11,0,1,0,0,0,1,12,DL
DELHI (UT),2001,Farming/Agriculture Activity,0,8,7,1,0,16,0,2,0,0,0,2,18,DL
DELHI (UT),2001,Retired Person,0,0,0,0,1,1,0,0,0,0,0,0,1,DL
DELHI (UT),2001,Total,15,315,260,115,25,730,28,282,157,31,11,509,1239,DL
DELHI (UT),2001,Total Salaried,0,89,70,34,2,195,0,14,2,0,0,16,211,DL
DELHI (UT),2001,Total Self-employed,3,84,100,41,8,236,6,46,31,1,3,87,323,DL
GOA,2001,Others (Please Specify),0,9,13,9,5,36,0,2,2,0,3,7,43,GA
GOA,2001,House Wife,0,0,0,0,0,0,0,11,24,6,14,55,55,GA
GOA,2001,Service (Government),0,0,2,2,0,4,0,0,1,0,1,2,6,GA
GOA,2001,Service (Private),0,11,29,6,0,46,0,5,1,0,0,6,52,GA
GOA,2001,Public Sector Undertaking,0,0,0,0,0,0,0,0,0,0,0,0,0,GA
GOA,2001,Student,0,4,0,0,0,4,3,6,0,0,0,9,13,GA
GOA,2001,Unemployed,0,17,21,3,3,44,0,6,4,0,0,10,54,GA
GOA,2001,Self-employed (Business activity),0,1,2,6,1,10,0,0,0,0,0,0,10,GA
GOA,2001,Professional Activity,0,0,2,0,0,2,0,0,0,0,0,0,2,GA
GOA,2001,Farming/Agriculture Activity,0,1,4,9,4,18,0,0,0,0,0,0,18,GA
GOA,2001,Retired Person,0,0,0,0,3,3,0,0,0,0,0,0,3,GA
GOA,2001,Total,0,43,73,35,16,167,3,30,32,6,18,89,256,GA
GOA,2001,Total Salaried,0,11,31,8,0,50,0,5,2,0,1,8,58,GA
GOA,2001,Total Self-employed,0,6,13,17,5,41,0,2,0,0,2,4,45,GA
GUJARAT,2001,Others (Please Specify),9,151,178,55,24,417,7,85,35,24,12,163,580,GJ
GUJARAT,2001,House Wife,0,0,0,0,0,0,15,736,534,199,84,1568,1568,GJ
GUJARAT,2001,Service (Government),0,12,26,24,0,62,0,3,5,0,0,8,70,GJ
GUJARAT,2001,Service (Private),0,145,169,45,6,365,0,18,14,7,0,39,404,GJ
GUJARAT,2001,Public Sector Undertaking,0,22,47,21,2,92,0,8,4,3,0,15,107,GJ
GUJARAT,2001,Student,19,109,6,0,0,134,28,101,1,0,0,130,264,GJ
GUJARAT,2001,Unemployed,5,210,137,66,8,426,6,27,28,10,0,71,497,GJ
GUJARAT,2001,Self-employed (Business activity),6,67,116,58,8,255,0,0,1,0,0,1,256,GJ
GUJARAT,2001,Professional Activity,0,98,127,86,14,325,0,18,5,2,2,27,352,GJ
GUJARAT,2001,Farming/Agriculture Activity,1,188,213,84,31,517,2,34,30,7,4,77,594,GJ
GUJARAT,2001,Retired Person,0,0,0,13,43,56,0,0,0,5,38,43,99,GJ
GUJARAT,2001,Total,40,1002,1019,452,136,2649,58,1030,657,257,140,2142,4791,GJ
GUJARAT,2001,Total Salaried,0,179,242,90,8,519,0,29,23,10,0,62,581,GJ
GUJARAT,2001,Total Self-employed,11,467,600,274,67,1419,6,109,58,22,16,211,1630,GJ
HARYANA,2001,Others (Please Specify),6,145,241,109,40,541,6,56,51,11,8,132,673,HR
HARYANA,2001,House Wife,0,0,0,0,0,0,0,167,104,15,11,297,297,HR
HARYANA,2001,Service (Government),0,25,32,16,0,73,0,0,13,8,0,21,94,HR
HARYANA,2001,Service (Private),0,40,45,13,0,98,0,24,15,6,2,47,145,HR
HARYANA,2001,Public Sector Undertaking,0,33,29,4,0,66,0,14,13,1,0,28,94,HR
HARYANA,2001,Student,15,64,8,0,0,87,7,29,2,3,0,41,128,HR
HARYANA,2001,Unemployed,13,117,52,42,3,227,7,26,18,9,0,60,287,HR
HARYANA,2001,Self-employed (Business activity),0,28,16,12,1,57,0,0,0,0,0,0,57,HR
HARYANA,2001,Professional Activity,0,17,33,12,2,64,0,0,1,0,0,1,65,HR
HARYANA,2001,Farming/Agriculture Activity,0,50,43,27,13,133,0,6,3,3,0,12,145,HR
HARYANA,2001,Retired Person,0,0,0,1,17,18,0,0,0,0,4,4,22,HR
HARYANA,2001,Total,34,519,499,236,76,1364,20,322,220,56,25,643,2007,HR
HARYANA,2001,Total Salaried,0,98,106,33,0,237,0,38,41,15,2,96,333,HR
HARYANA,2001,Total Self-employed,0,122,143,65,27,357,0,10,21,6,4,41,398,HR
HIMACHAL PRADESH,2001,Others (Please Specify),1,15,22,21,6,65,1,9,9,2,3,24,89,HP
HIMACHAL PRADESH,2001,House Wife,0,0,0,0,0,0,0,44,26,12,2,84,84,HP
HIMACHAL PRADESH,2001,Service (Government),0,0,5,3,0,8,0,2,1,0,0,3,11,HP
HIMACHAL PRADESH,2001,Service (Private),0,6,9,8,1,24,0,0,0,0,0,0,24,HP
HIMACHAL PRADESH,2001,Public Sector Undertaking,0,0,3,4,0,7,0,0,0,0,0,0,7,HP
HIMACHAL PRADESH,2001,Student,0,8,0,0,0,8,2,9,0,0,0,11,19,HP
HIMACHAL PRADESH,2001,Unemployed,0,18,9,4,0,31,0,6,1,0,0,7,38,HP
HIMACHAL PRADESH,2001,Self-employed (Business activity),0,4,5,0,0,9,0,0,0,0,0,0,9,HP
HIMACHAL PRADESH,2001,Professional Activity,0,0,2,0,0,2,0,0,1,0,0,1,3,HP
HIMACHAL PRADESH,2001,Farming/Agriculture Activity,0,3,9,8,2,22,0,0,0,0,0,0,22,HP
HIMACHAL PRADESH,2001,Retired Person,0,0,0,1,0,1,0,0,0,0,0,0,1,HP
HIMACHAL PRADESH,2001,Total,1,54,64,49,9,177,3,70,38,14,5,130,307,HP
HIMACHAL PRADESH,2001,Total Salaried,0,6,17,15,1,39,0,2,1,0,0,3,42,HP
HIMACHAL PRADESH,2001,Total Self-employed,0,8,22,13,3,46,0,0,7,0,0,7,53,HP
JAMMU & KASHMIR,2001,Others (Please Specify),0,14,12,10,10,46,1,9,7,0,2,19,65,JK
JAMMU & KASHMIR,2001,House Wife,0,0,0,0,0,0,0,18,13,4,1,36,36,JK
JAMMU & KASHMIR,2001,Service (Government),0,1,7,1,0,9,0,0,0,0,0,0,9,JK
JAMMU & KASHMIR,2001,Service (Private),0,0,2,0,0,2,0,0,0,0,0,0,2,JK
JAMMU & KASHMIR,2001,Public Sector Undertaking,0,0,1,0,0,1,0,0,0,0,0,0,1,JK
JAMMU & KASHMIR,2001,Student,0,5,0,0,0,5,0,1,0,0,0,1,6,JK
JAMMU & KASHMIR,2001,Unemployed,0,3,4,4,1,12,0,3,0,0,0,3,15,JK
JAMMU & KASHMIR,2001,Self-employed (Business activity),0,1,1,0,0,2,0,0,0,0,0,0,2,JK
JAMMU & KASHMIR,2001,Professional Activity,2,0,0,0,0,2,0,0,0,0,0,0,2,JK
JAMMU & KASHMIR,2001,Farming/Agriculture Activity,0,5,4,3,0,12,1,0,1,1,0,3,15,JK
JAMMU & KASHMIR,2001,Retired Person,0,0,0,0,0,0,0,0,0,0,0,0,0,JK
JAMMU & KASHMIR,2001,Total,2,29,31,18,11,91,2,31,21,5,3,62,153,JK
JAMMU & KASHMIR,2001,Total Salaried,0,1,10,1,0,12,0,0,0,0,0,0,12,JK
JAMMU & KASHMIR,2001,Total Self-employed,2,9,9,4,0,24,1,4,1,1,0,7,31,JK
JHARKHAND,2001,Others (Please Specify),1,25,23,18,9,76,4,19,6,15,0,44,120,JH
JHARKHAND,2001,House Wife,0,0,0,0,0,0,1,29,21,8,0,59,59,JH
JHARKHAND,2001,Service (Government),0,0,0,0,0,0,0,0,0,0,0,0,0,JH
JHARKHAND,2001,Service (Private),0,0,3,1,0,4,0,0,2,0,0,2,6,JH
JHARKHAND,2001,Public Sector Undertaking,0,0,3,0,0,3,0,0,2,0,0,2,5,JH
JHARKHAND,2001,Student,3,3,0,0,0,6,0,1,0,0,0,1,7,JH
JHARKHAND,2001,Unemployed,0,9,7,1,1,18,0,1,0,0,0,1,19,JH
JHARKHAND,2001,Self-employed (Business activity),0,0,1,0,0,1,0,0,0,0,0,0,1,JH
JHARKHAND,2001,Professional Activity,0,3,2,1,0,6,0,0,0,0,0,0,6,JH
JHARKHAND,2001,Farming/Agriculture Activity,0,5,17,5,0,27,0,0,0,0,0,0,27,JH
JHARKHAND,2001,Retired Person,0,0,0,0,0,0,0,0,0,0,0,0,0,JH
JHARKHAND,2001,Total,4,45,56,26,10,141,5,50,31,23,0,109,250,JH
JHARKHAND,2001,Total Salaried,0,0,6,1,0,7,0,0,4,0,0,4,11,JH
JHARKHAND,2001,Total Self-employed,0,26,31,13,0,70,1,12,0,2,0,15,85,JH
KARNATAKA,2001,Others (Please Specify),68,614,971,646,346,2645,83,321,184,160,90,838,3483,KA
KARNATAKA,2001,House Wife,0,0,0,0,0,0,10,1008,707,334,138,2197,2197,KA
KARNATAKA,2001,Service (Government),0,35,108,67,1,211,0,23,24,12,0,59,270,KA
KARNATAKA,2001,Service (Private),3,241,352,190,79,865,6,111,40,31,12,200,1065,KA
KARNATAKA,2001,Public Sector Undertaking,0,66,95,60,7,228,0,15,0,0,0,15,243,KA
KARNATAKA,2001,Student,72,230,26,1,0,329,60,120,1,2,0,183,512,KA
KARNATAKA,2001,Unemployed,6,225,207,103,17,558,5,48,23,5,4,85,643,KA
KARNATAKA,2001,Self-employed (Business activity),5,195,221,133,37,591,2,22,7,3,0,34,625,KA
KARNATAKA,2001,Professional Activity,1,69,71,41,13,195,1,6,1,0,0,8,203,KA
KARNATAKA,2001,Farming/Agriculture Activity,25,551,811,579,187,2153,17,138,117,68,12,352,2505,KA
KARNATAKA,2001,Retired Person,0,16,18,16,46,96,0,5,14,11,9,39,135,KA
KARNATAKA,2001,Total,180,2242,2880,1836,733,7871,184,1817,1118,626,265,4010,11881,KA
KARNATAKA,2001,Total Salaried,3,342,555,317,87,1304,6,149,64,43,12,274,1578,KA
KARNATAKA,2001,Total Self-employed,79,1256,1811,1237,503,4886,56,367,255,162,71,911,5797,KA
KERALA,2001,Others (Please Specify),6,409,719,725,486,2345,12,168,155,152,101,588,2933,KL
KERALA,2001,House Wife,0,0,0,0,0,0,0,290,475,394,247,1406,1406,KL
KERALA,2001,Service (Government),0,10,53,111,2,176,0,7,15,9,0,31,207,KL
KERALA,2001,Service (Private),0,73,145,139,92,449,0,25,33,24,35,117,566,KL
KERALA,2001,Public Sector Undertaking,0,35,48,63,37,183,0,3,12,10,2,27,210,KL
KERALA,2001,Student,37,90,1,0,0,128,33,119,1,0,0,153,281,KL
KERALA,2001,Unemployed,0,312,550,560,334,1756,3,155,74,41,66,339,2095,KL
KERALA,2001,Self-employed (Business activity),0,56,187,177,55,475,0,7,5,9,1,22,497,KL
KERALA,2001,Professional Activity,0,30,77,74,21,202,0,2,9,8,2,21,223,KL
KERALA,2001,Farming/Agriculture Activity,0,93,325,362,194,974,0,18,17,12,14,61,1035,KL
KERALA,2001,Retired Person,0,1,2,29,67,99,0,0,2,7,11,20,119,KL
KERALA,2001,Total,43,1109,2107,2240,1288,6787,48,794,798,666,479,2785,9572,KL
KERALA,2001,Total Salaried,0,118,246,313,131,808,0,35,60,43,37,175,983,KL
KERALA,2001,Total Self-employed,6,449,1045,1117,569,3186,3,107,95,112,79,396,3582,KL
LAKSHADWEEP,2001,Others (Please Specify),0,0,0,0,0,0,0,0,0,0,0,0,0,LD
LAKSHADWEEP,2001,House Wife,0,0,0,0,0,0,0,0,0,0,0,0,0,LD
LAKSHADWEEP,2001,Service (Government),0,0,0,0,0,0,0,0,0,0,0,0,0,LD
LAKSHADWEEP,2001,Service (Private),0,0,0,0,0,0,0,0,0,0,0,0,0,LD
LAKSHADWEEP,2001,Public Sector Undertaking,0,0,0,0,0,0,0,0,0,0,0,0,0,LD
LAKSHADWEEP,2001,Student,0,0,0,0,0,0,0,0,0,0,0,0,0,LD
LAKSHADWEEP,2001,Unemployed,0,0,0,0,0,0,0,0,0,0,0,0,0,LD
LAKSHADWEEP,2001,Self-employed (Business activity),0,0,0,0,0,0,0,0,0,0,0,0,0,LD
LAKSHADWEEP,2001,Professional Activity,0,0,0,0,0,0,0,0,0,0,0,0,0,LD
LAKSHADWEEP,2001,Farming/Agriculture Activity,0,0,0,0,0,0,0,0,0,0,0,0,0,LD
LAKSHADWEEP,2001,Retired Person,0,0,0,0,0,0,0,0,0,0,0,0,0,LD
LAKSHADWEEP,2001,Total,0,0,0,0,0,0,0,0,0,0,0,0,0,LD
LAKSHADWEEP,2001,Total Salaried,0,0,0,0,0,0,0,0,0,0,0,0,0,LD
LAKSHADWEEP,2001,Total Self-employed,0,0,0,0,0,0,0,0,0,0,0,0,0,LD
MADHYA PRADESH,2001,Others (Please Specify),73,437,352,197,125,1184,62,228,107,58,38,493,1677,MP
MADHYA PRADESH,2001,House Wife,0,0,0,0,0,0,14,1346,553,201,87,2201,2201,MP
MADHYA PRADESH,2001,Service (Government),0,59,54,40,1,154,0,13,12,3,0,28,182,MP
MADHYA PRADESH,2001,Service (Private),0,142,108,40,4,294,0,48,10,5,0,63,357,MP
MADHYA PRADESH,2001,Public Sector Undertaking,0,43,10,9,0,62,0,36,6,2,0,44,106,MP
MADHYA PRADESH,2001,Student,50,147,11,3,0,211,32,62,0,0,0,94,305,MP
MADHYA PRADESH,2001,Unemployed,2,91,63,23,18,197,2,11,0,0,0,13,210,MP
MADHYA PRADESH,2001,Self-employed (Business activity),0,71,83,40,23,217,0,28,21,11,11,71,288,MP
MADHYA PRADESH,2001,Professional Activity,0,30,64,20,12,126,0,4,8,7,3,22,148,MP
MADHYA PRADESH,2001,Farming/Agriculture Activity,5,397,384,198,94,1078,5,142,95,31,21,294,1372,MP
MADHYA PRADESH,2001,Retired Person,0,0,0,0,13,13,0,0,0,0,1,1,14,MP
MADHYA PRADESH,2001,Total,130,1417,1129,570,290,3536,115,1918,812,318,161,3324,6860,MP
MADHYA PRADESH,2001,Total Salaried,0,244,172,89,5,510,0,97,28,10,0,135,645,MP
MADHYA PRADESH,2001,Total Self-employed,45,728,725,406,214,2118,48,279,183,79,49,638,2756,MP
MAHARASHTRA,2001,Others (Please Specify),36,683,1054,500,297,2570,33,243,213,84,42,615,3185,MH
MAHARASHTRA,2001,House Wife,0,0,0,0,0,0,9,1663,1078,394,207,3351,3351,MH
MAHARASHTRA,2001,Service (Government),0,51,111,57,3,222,0,19,15,3,0,37,259,MH
MAHARASHTRA,2001,Service (Private),0,346,561,337,40,1284,0,74,48,21,2,145,1429,MH
MAHARASHTRA,2001,Public Sector Undertaking,0,33,40,38,2,113,0,7,3,1,0,11,124,MH
MAHARASHTRA,2001,Student,81,337,15,0,0,433,78,273,5,0,0,356,789,MH
MAHARASHTRA,2001,Unemployed,0,386,357,162,51,956,0,60,19,17,5,101,1057,MH
MAHARASHTRA,2001,Self-employed (Business activity),0,118,157,108,18,401,0,10,16,11,0,37,438,MH
MAHARASHTRA,2001,Professional Activity,0,62,106,54,22,244,0,6,5,9,4,24,268,MH
MAHARASHTRA,2001,Farming/Agriculture Activity,11,789,1263,643,239,2945,13,278,205,72,23,591,3536,MH
MAHARASHTRA,2001,Retired Person,0,0,6,39,125,170,0,0,0,5,7,12,182,MH
MAHARASHTRA,2001,Total,128,2805,3670,1938,797,9338,133,2633,1607,617,290,5280,14618,MH
MAHARASHTRA,2001,Total Salaried,0,430,712,432,45,1619,0,100,66,25,2,193,1812,MH
MAHARASHTRA,2001,Total Self-employed,44,1609,2510,1276,556,5995,40,522,427,173,69,1231,7226,MH
MANIPUR,2001,Others (Please Specify),0,4,5,3,1,13,0,7,0,0,0,7,20,MN
MANIPUR,2001,House Wife,0,0,0,0,0,0,0,3,5,1,0,9,9,MN
MANIPUR,2001,Service (Government),0,0,0,0,0,0,0,0,0,0,0,0,0,MN
MANIPUR,2001,Service (Private),0,0,0,0,0,0,0,0,0,0,0,0,0,MN
MANIPUR,2001,Public Sector Undertaking,0,3,0,0,0,3,0,0,0,0,0,0,3,MN
MANIPUR,2001,Student,1,5,0,0,0,6,0,1,0,0,0,1,7,MN
MANIPUR,2001,Unemployed,0,0,0,2,0,2,0,0,0,0,0,0,2,MN
MANIPUR,2001,Self-employed (Business activity),0,0,0,0,0,0,0,0,0,0,0,0,0,MN
MANIPUR,2001,Professional Activity,0,0,0,0,0,0,0,0,0,0,0,0,0,MN
MANIPUR,2001,Farming/Agriculture Activity,0,0,0,0,0,0,0,0,0,0,0,0,0,MN
MANIPUR,2001,Retired Person,0,0,0,0,0,0,0,0,0,0,0,0,0,MN
MANIPUR,2001,Total,1,12,5,5,1,24,0,11,5,1,0,17,41,MN
MANIPUR,2001,Total Salaried,0,3,0,0,0,3,0,0,0,0,0,0,3,MN
MANIPUR,2001,Total Self-employed,0,0,4,3,1,8,0,3,0,0,0,3,11,MN
MEGHALAYA,2001,Others (Please Specify),0,8,16,4,1,29,0,3,0,3,1,7,36,ML
MEGHALAYA,2001,House Wife,0,0,0,0,0,0,0,3,1,0,0,4,4,ML
MEGHALAYA,2001,Service (Government),0,1,6,0,1,8,0,1,1,0,0,2,10,ML
MEGHALAYA,2001,Service (Private),0,0,2,0,0,2,0,0,0,0,0,0,2,ML
MEGHALAYA,2001,Public Sector Undertaking,0,0,0,0,0,0,0,0,0,0,0,0,0,ML
MEGHALAYA,2001,Student,1,4,2,0,0,7,0,0,0,0,0,0,7,ML
MEGHALAYA,2001,Unemployed,0,7,3,0,2,12,0,2,0,0,0,2,14,ML
MEGHALAYA,2001,Self-employed (Business activity),0,2,2,0,0,4,0,0,0,0,0,0,4,ML
MEGHALAYA,2001,Professional Activity,0,0,1,1,0,2,0,0,0,0,0,0,2,ML
MEGHALAYA,2001,Farming/Agriculture Activity,0,0,2,0,0,2,0,2,0,0,0,2,4,ML
MEGHALAYA,2001,Retired Person,0,0,2,0,1,3,0,0,0,0,1,1,4,ML
MEGHALAYA,2001,Total,1,22,36,5,5,69,0,11,2,3,2,18,87,ML
MEGHALAYA,2001,Total Salaried,0,1,8,0,1,10,0,1,1,0,0,2,12,ML
MEGHALAYA,2001,Total Self-employed,0,10,19,5,0,34,0,5,0,3,1,9,43,ML
MIZORAM,2001,Others (Please Specify),4,5,5,4,1,19,0,0,1,0,1,2,21,MZ
MIZORAM,2001,House Wife,0,0,0,0,0,0,0,0,0,0,0,0,0,MZ
MIZORAM,2001,Service (Government),0,2,1,0,0,3,0,0,0,0,0,0,3,MZ
MIZORAM,2001,Service (Private),0,2,0,0,0,2,0,0,0,0,0,0,2,MZ
MIZORAM,2001,Public Sector Undertaking,0,0,0,0,0,0,0,0,0,0,0,0,0,MZ
MIZORAM,2001,Student,1,11,0,0,0,12,0,1,0,0,0,1,13,MZ
MIZORAM,2001,Unemployed,2,2,4,1,0,9,0,2,1,2,0,5,14,MZ
MIZORAM,2001,Self-employed (Business activity),0,0,0,0,0,0,0,0,0,0,0,0,0,MZ
MIZORAM,2001,Professional Activity,0,0,0,0,0,0,0,0,0,0,0,0,0,MZ
MIZORAM,2001,Farming/Agriculture Activity,0,0,0,0,0,0,0,0,0,0,0,0,0,MZ
MIZORAM,2001,Retired Person,0,0,0,0,1,1,0,0,0,0,0,0,1,MZ
MIZORAM,2001,Total,7,22,10,5,2,46,0,3,2,2,1,8,54,MZ
MIZORAM,2001,Total Salaried,0,4,1,0,0,5,0,0,0,0,0,0,5,MZ
MIZORAM,2001,Total Self-employed,0,5,0,4,1,10,0,0,1,0,1,2,12,MZ
NAGALAND,2001,Others (Please Specify),0,1,0,0,0,1,0,0,0,0,0,0,1,NG
NAGALAND,2001,House Wife,0,0,0,0,0,0,0,2,4,0,0,6,6,NG
NAGALAND,2001,Service (Government),0,1,3,1,0,5,0,0,1,0,0,1,6,NG
NAGALAND,2001,Service (Private),0,1,3,0,0,4,0,1,0,0,0,1,5,NG
NAGALAND,2001,Public Sector Undertaking,0,0,0,0,0,0,0,0,0,0,0,0,0,NG
NAGALAND,2001,Student,0,0,0,0,0,0,0,0,0,1,0,1,1,NG
NAGALAND,2001,Unemployed,0,5,7,1,0,13,0,4,0,2,0,6,19,NG
NAGALAND,2001,Self-employed (Business activity),0,0,2,0,0,2,0,0,0,0,0,0,2,NG
NAGALAND,2001,Professional Activity,0,0,0,0,0,0,0,0,0,0,0,0,0,NG
NAGALAND,2001,Farming/Agriculture Activity,0,0,0,0,0,0,0,0,0,0,0,0,0,NG
NAGALAND,2001,Retired Person,0,0,0,0,0,0,0,0,0,0,0,0,0,NG
NAGALAND,2001,Total,0,8,15,2,0,25,0,7,5,3,0,15,40,NG
NAGALAND,2001,Total Salaried,0,2,6,1,0,9,0,1,1,0,0,2,11,NG
NAGALAND,2001,Total Self-employed,0,0,2,0,0,2,0,0,0,0,0,0,2,NG
ODISHA,2001,Others (Please Specify),12,274,292,251,90,919,33,236,202,85,44,600,1519,OD
ODISHA,2001,House Wife,0,0,0,0,0,0,2,347,330,135,26,840,840,OD
ODISHA,2001,Service (Government),0,23,25,8,0,56,0,13,6,1,0,20,76,OD
ODISHA,2001,Service (Private),0,58,52,32,8,150,0,49,27,7,0,83,233,OD
ODISHA,2001,Public Sector Undertaking,0,16,20,5,0,41,0,13,17,2,2,34,75,OD
ODISHA,2001,Student,24,111,9,0,0,144,27,94,0,1,2,124,268,OD
ODISHA,2001,Unemployed,0,87,100,26,7,220,0,67,33,1,0,101,321,OD
ODISHA,2001,Self-employed (Business activity),0,71,111,104,9,295,0,36,46,20,2,104,399,OD
ODISHA,2001,Professional Activity,0,10,13,6,2,31,0,4,0,0,2,6,37,OD
ODISHA,2001,Farming/Agriculture Activity,0,56,87,47,17,207,0,22,18,8,1,49,256,OD
ODISHA,2001,Retired Person,0,2,0,13,11,26,0,0,0,0,2,2,28,OD
ODISHA,2001,Total,36,708,709,492,144,2089,62,881,679,260,81,1963,4052,OD
ODISHA,2001,Total Salaried,0,97,97,45,8,247,0,75,50,10,2,137,384,OD
ODISHA,2001,Total Self-employed,6,257,393,326,93,1075,16,219,208,91,41,575,1650,OD
PUDUCHERRY,2001,Others (Please Specify),0,18,26,15,1,60,0,2,0,0,0,2,62,PY
PUDUCHERRY,2001,House Wife,0,0,0,0,0,0,0,63,46,18,7,134,134,PY
PUDUCHERRY,2001,Service (Government),0,0,5,0,0,5,0,0,0,1,0,1,6,PY
PUDUCHERRY,2001,Service (Private),0,26,44,22,2,94,0,5,1,0,0,6,100,PY
PUDUCHERRY,2001,Public Sector Undertaking,0,0,1,3,0,4,0,0,0,1,0,1,5,PY
PUDUCHERRY,2001,Student,2,7,0,0,0,9,4,18,0,0,0,22,31,PY
PUDUCHERRY,2001,Unemployed,0,14,6,5,26,51,2,27,3,0,0,32,83,PY
PUDUCHERRY,2001,Self-employed (Business activity),0,7,5,4,1,17,0,0,0,0,0,0,17,PY
PUDUCHERRY,2001,Professional Activity,0,0,0,0,0,0,0,0,0,0,0,0,0,PY
PUDUCHERRY,2001,Farming/Agriculture Activity,0,10,28,35,10,83,0,5,1,2,0,8,91,PY
PUDUCHERRY,2001,Retired Person,0,0,0,0,0,0,0,0,0,0,0,0,0,PY
PUDUCHERRY,2001,Total,2,82,115,84,40,323,6,120,51,22,7,206,529,PY
PUDUCHERRY,2001,Total Salaried,0,26,50,25,2,103,0,5,1,2,0,8,111,PY
PUDUCHERRY,2001,Total Self-employed,0,35,59,54,12,160,0,7,1,2,0,10,170,PY
PUNJAB,2001,Others (Please Specify),0,48,33,108,16,205,0,74,31,11,9,125,330,PN
PUNJAB,2001,House Wife,0,0,0,0,0,0,0,55,28,6,9,98,98,PN
PUNJAB,2001,Service (Government),0,5,5,3,1,14,0,3,0,0,0,3,17,PN
PUNJAB,2001,Service (Private),0,17,9,4,2,32,0,3,2,1,0,6,38,PN
PUNJAB,2001,Public Sector Undertaking,0,4,2,1,1,8,0,2,1,0,0,3,11,PN
PUNJAB,2001,Student,0,5,0,0,0,5,0,3,0,0,0,3,8,PN
PUNJAB,2001,Unemployed,0,24,15,3,19,61,0,6,4,0,0,10,71,PN
PUNJAB,2001,Self-employed (Business activity),0,9,0,6,1,16,0,0,0,1,0,1,17,PN
PUNJAB,2001,Professional Activity,1,3,0,1,2,7,0,0,0,0,0,0,7,PN
PUNJAB,2001,Farming/Agriculture Activity,0,14,0,9,19,42,0,3,0,0,0,3,45,PN
PUNJAB,2001,Retired Person,0,0,0,0,6,6,0,0,0,0,0,0,6,PN
PUNJAB,2001,Total,1,129,64,135,67,396,0,149,66,19,18,252,648,PN
PUNJAB,2001,Total Salaried,0,26,16,8,4,54,0,8,3,1,0,12,66,PN
PUNJAB,2001,Total Self-employed,1,43,0,20,26,90,0,5,1,1,0,7,97,PN
RAJASTHAN,2001,Others (Please Specify),50,169,235,167,74,695,28,95,67,12,14,216,911,RJ
RAJASTHAN,2001,House Wife,0,0,0,0,0,0,2,391,265,101,24,783,783,RJ
RAJASTHAN,2001,Service (Government),0,14,33,12,0,59,0,2,0,1,0,3,62,RJ
RAJASTHAN,2001,Service (Private),0,88,84,36,10,218,0,14,11,2,0,27,245,RJ
RAJASTHAN,2001,Public Sector Undertaking,0,24,41,7,0,72,0,4,6,1,0,11,83,RJ
RAJASTHAN,2001,Student,34,68,14,5,0,121,30,53,0,0,0,83,204,RJ
RAJASTHAN,2001,Unemployed,0,89,70,18,2,179,0,19,2,0,0,21,200,RJ
RAJASTHAN,2001,Self-employed (Business activity),0,56,49,29,9,143,0,8,3,0,0,11,154,RJ
RAJASTHAN,2001,Professional Activity,1,13,14,11,1,40,0,0,0,0,0,0,40,RJ
RAJASTHAN,2001,Farming/Agriculture Activity,1,156,173,78,16,424,1,38,33,5,4,81,505,RJ
RAJASTHAN,2001,Retired Person,0,0,0,0,8,8,0,0,0,0,0,0,8,RJ
RAJASTHAN,2001,Total,86,677,713,363,120,1959,61,624,387,122,42,1236,3195,RJ
RAJASTHAN,2001,Total Salaried,0,126,158,55,10,349,0,20,17,4,0,41,390,RJ
RAJASTHAN,2001,Total Self-employed,47,313,363,210,55,988,22,111,64,10,16,223,1211,RJ
SIKKIM,2001,Others (Please Specify),0,9,6,1,0,16,0,0,0,0,0,0,16,SK
SIKKIM,2001,House Wife,0,0,0,0,0,0,0,2,10,0,0,12,12,SK
SIKKIM,2001,Service (Government),0,1,1,0,0,2,0,2,1,0,0,3,5,SK
SIKKIM,2001,Service (Private),0,3,4,0,0,7,0,0,0,0,0,0,7,SK
SIKKIM,2001,Public Sector Undertaking,0,1,0,0,0,1,0,0,0,0,0,0,1,SK
SIKKIM,2001,Student,0,1,0,0,0,1,2,2,0,0,0,4,5,SK
SIKKIM,2001,Unemployed,0,4,3,0,1,8,0,3,1,0,0,4,12,SK
SIKKIM,2001,Self-employed (Business activity),0,0,3,0,0,3,0,0,0,0,0,0,3,SK
SIKKIM,2001,Professional Activity,0,2,6,0,0,8,0,3,4,0,0,7,15,SK
SIKKIM,2001,Farming/Agriculture Activity,0,6,4,4,2,16,0,2,0,0,0,2,18,SK
SIKKIM,2001,Retired Person,0,0,0,0,0,0,0,0,0,0,0,0,0,SK
SIKKIM,2001,Total,0,27,27,5,3,62,2,14,16,0,0,32,94,SK
SIKKIM,2001,Total Salaried,0,5,5,0,0,10,0,2,1,0,0,3,13,SK
SIKKIM,2001,Total Self-employed,0,17,19,5,2,43,0,5,4,0,0,9,52,SK
TAMIL NADU,2001,Others (Please Specify),82,764,913,534,226,2519,73,340,315,205,93,1026,3545,TN
TAMIL NADU,2001,House Wife,0,0,0,0,0,0,0,822,632,226,75,1755,1755,TN
TAMIL NADU,2001,Service (Government),0,21,63,79,3,166,0,23,33,10,1,67,233,TN
TAMIL NADU,2001,Service (Private),2,221,375,207,45,850,3,89,89,48,5,234,1084,TN
TAMIL NADU,2001,Public Sector Undertaking,0,75,78,50,4,207,0,45,42,9,2,98,305,TN
TAMIL NADU,2001,Student,46,180,10,0,0,236,39,116,7,6,0,168,404,TN
TAMIL NADU,2001,Unemployed,6,333,540,402,49,1330,21,178,238,76,15,528,1858,TN
TAMIL NADU,2001,Self-employed (Business activity),2,134,309,164,47,656,2,12,11,31,1,57,713,TN
TAMIL NADU,2001,Professional Activity,3,83,141,58,9,294,0,14,27,23,0,64,358,TN
TAMIL NADU,2001,Farming/Agriculture Activity,5,304,253,170,94,826,7,63,50,24,15,159,985,TN
TAMIL NADU,2001,Retired Person,0,0,0,9,35,44,0,0,0,0,6,6,50,TN
TAMIL NADU,2001,Total,146,2115,2682,1673,512,7128,145,1702,1444,658,213,4162,11290,TN
TAMIL NADU,2001,Total Salaried,2,317,516,336,52,1223,3,157,164,67,8,399,1622,TN
TAMIL NADU,2001,Total Self-employed,28,1013,1211,705,285,3242,17,305,260,200,71,853,4095,TN
TRIPURA,2001,Others (Please Specify),6,68,101,70,29,274,5,61,126,51,19,262,536,TR
TRIPURA,2001,House Wife,0,0,0,0,0,0,0,20,40,8,3,71,71,TR
TRIPURA,2001,Service (Government),0,0,0,0,0,0,0,0,0,0,0,0,0,TR
TRIPURA,2001,Service (Private),0,2,10,1,0,13,0,0,0,2,0,2,15,TR
TRIPURA,2001,Public Sector Undertaking,0,0,0,0,0,0,0,3,0,0,0,3,3,TR
TRIPURA,2001,Student,10,18,9,0,0,37,5,10,18,0,0,33,70,TR
TRIPURA,2001,Unemployed,2,20,14,2,2,40,2,10,1,1,0,14,54,TR
TRIPURA,2001,Self-employed (Business activity),0,9,30,10,0,49,0,2,0,0,0,2,51,TR
TRIPURA,2001,Professional Activity,0,4,4,1,0,9,0,2,2,0,0,4,13,TR
TRIPURA,2001,Farming/Agriculture Activity,0,10,26,3,2,41,0,0,0,0,0,0,41,TR
TRIPURA,2001,Retired Person,0,0,0,0,0,0,0,0,0,0,0,0,0,TR
TRIPURA,2001,Total,18,131,194,87,33,463,12,108,187,62,22,391,854,TR
TRIPURA,2001,Total Salaried,0,2,10,1,0,13,0,3,0,2,0,5,18,TR
TRIPURA,2001,Total Self-employed,0,39,85,20,5,149,0,14,3,4,4,25,174,TR
UTTAR PRADESH,2001,Others (Please Specify),16,86,105,63,32,302,23,113,76,50,36,298,600,UP
UTTAR PRADESH,2001,House Wife,0,0,0,0,0,0,13,577,374,87,24,1075,1075,UP
UTTAR PRADESH,2001,Service (Government),0,8,16,6,1,31,0,15,11,0,0,26,57,UP
UTTAR PRADESH,2001,Service (Private),1,113,85,39,1,239,1,34,23,15,0,73,312,UP
UTTAR PRADESH,2001,Public Sector Undertaking,0,22,11,4,2,39,0,5,2,0,0,7,46,UP
UTTAR PRADESH,2001,Student,38,82,3,0,0,123,20,66,2,0,0,88,211,UP
UTTAR PRADESH,2001,Unemployed,12,167,96,34,7,316,2,12,4,2,0,20,336,UP
UTTAR PRADESH,2001,Self-employed (Business activity),0,55,37,33,6,131,0,7,1,0,0,8,139,UP
UTTAR PRADESH,2001,Professional Activity,0,8,17,9,3,37,0,1,2,1,0,4,41,UP
UTTAR PRADESH,2001,Farming/Agriculture Activity,6,175,175,140,82,578,4,39,40,19,8,110,688,UP
UTTAR PRADESH,2001,Retired Person,0,0,0,2,3,5,0,1,2,1,2,6,11,UP
UTTAR PRADESH,2001,Total,73,716,545,330,137,1801,63,870,537,175,70,1715,3516,UP
UTTAR PRADESH,2001,Total Salaried,1,143,112,49,4,309,1,54,36,15,0,106,415,UP
UTTAR PRADESH,2001,Total Self-employed,17,295,295,227,111,945,15,135,102,67,44,363,1308,UP
UTTARAKHAND,2001,Others (Please Specify),0,8,16,11,2,37,0,11,10,1,0,22,59,UK
UTTARAKHAND,2001,House Wife,0,0,0,0,0,0,0,30,24,8,2,64,64,UK
UTTARAKHAND,2001,Service (Government),0,2,6,2,0,10,0,9,1,0,0,10,20,UK
UTTARAKHAND,2001,Service (Private),1,3,41,18,2,65,3,9,5,0,0,17,82,UK
UTTARAKHAND,2001,Public Sector Undertaking,0,1,1,0,0,2,0,0,0,0,0,0,2,UK
UTTARAKHAND,2001,Student,2,10,0,0,0,12,1,8,0,0,0,9,21,UK
UTTARAKHAND,2001,Unemployed,0,10,18,0,0,28,0,3,0,1,0,4,32,UK
UTTARAKHAND,2001,Self-employed (Business activity),0,4,0,4,0,8,0,0,0,0,0,0,8,UK
UTTARAKHAND,2001,Professional Activity,0,0,0,0,0,0,0,0,0,0,0,0,0,UK
UTTARAKHAND,2001,Farming/Agriculture Activity,0,3,9,5,1,18,0,2,1,0,0,3,21,UK
UTTARAKHAND,2001,Retired Person,0,0,0,2,0,2,0,0,0,0,0,0,2,UK
UTTARAKHAND,2001,Total,3,41,91,42,5,182,4,72,41,10,2,129,311,UK
UTTARAKHAND,2001,Total Salaried,1,6,48,20,2,77,3,18,6,0,0,27,104,UK
UTTARAKHAND,2001,Total Self-employed,0,14,21,18,3,56,0,12,9,1,0,22,78,UK
WEST BENGAL,2001,Others (Please Specify),125,711,1114,787,324,3061,151,794,809,563,265,2582,5643,WB
WEST BENGAL,2001,House Wife,0,0,0,0,0,0,0,653,588,242,72,1555,1555,WB
WEST BENGAL,2001,Service (Government),0,42,65,68,7,182,0,38,65,13,5,121,303,WB
WEST BENGAL,2001,Service (Private),16,229,366,335,49,995,41,118,121,97,48,425,1420,WB
WEST BENGAL,2001,Public Sector Undertaking,0,170,111,137,55,473,0,93,104,64,8,269,742,WB
WEST BENGAL,2001,Student,132,263,2,0,0,397,73,331,13,0,0,417,814,WB
WEST BENGAL,2001,Unemployed,2,217,229,186,12,646,0,99,110,14,0,223,869,WB
WEST BENGAL,2001,Self-employed (Business activity),0,88,193,195,33,509,0,34,44,51,37,166,675,WB
WEST BENGAL,2001,Professional Activity,0,23,67,64,41,195,5,22,28,16,10,81,276,WB
WEST BENGAL,2001,Farming/Agriculture Activity,8,284,279,266,98,935,13,72,133,93,0,311,1246,WB
WEST BENGAL,2001,Retired Person,0,0,0,8,94,102,0,0,0,17,28,45,147,WB
WEST BENGAL,2001,Total,283,2027,2426,2046,713,7495,283,2254,2015,1170,473,6195,13690,WB
WEST BENGAL,2001,Total Salaried,16,441,542,540,111,1650,41,249,290,174,61,815,2465,WB
WEST BENGAL,2001,Total Self-employed,29,759,867,816,325,2796,42,399,470,375,119,1405,4201,WB
A & N ISLANDS,2002,Others (Please Specify),0,0,1,0,0,1,0,0,0,0,0,0,1,AN
A & N ISLANDS,2002,House Wife,0,0,0,0,0,0,0,22,13,6,3,44,44,AN
A & N ISLANDS,2002,Service (Government),0,2,8,8,0,18,0,0,1,0,0,1,19,AN
A & N ISLANDS,2002,Service (Private),0,20,16,13,7,56,0,0,0,0,0,0,56,AN
A & N ISLANDS,2002,Public Sector Undertaking,0,0,0,0,0,0,0,0,0,0,0,0,0,AN
A & N ISLANDS,2002,Student,2,3,0,0,0,5,2,6,0,0,0,8,13,AN
A & N ISLANDS,2002,Unemployed,0,0,0,0,0,0,0,0,0,0,0,0,0,AN
A & N ISLANDS,2002,Self-employed (Business activity),0,1,0,0,0,1,0,0,0,0,0,0,1,AN
A & N ISLANDS,2002,Professional Activity,0,0,0,0,0,0,0,0,0,0,0,0,0,AN
A & N ISLANDS,2002,Farming/Agriculture Activity,0,1,3,0,3,7,0,0,0,0,0,0,7,AN
A & N ISLANDS,2002,Retired Person,0,0,0,0,3,3,0,0,0,0,0,0,3,AN
A & N ISLANDS,2002,Total,2,27,28,21,13,91,2,28,14,6,3,53,144,AN
A & N ISLANDS,2002,Total Salaried,0,22,24,21,7,74,0,0,1,0,0,1,75,AN
A & N ISLANDS,2002,Total Self-employed,0,2,4,0,3,9,0,0,0,0,0,0,9,AN
ANDHRA PRADESH,2002,Others (Please Specify),39,696,1169,815,274,2993,55,382,337,115,112,1001,3994,AP
ANDHRA PRADESH,2002,House Wife,0,0,0,0,0,0,0,1009,773,319,91,2192,2192,AP
ANDHRA PRADESH,2002,Service (Government),0,19,56,25,0,100,0,6,10,5,0,21,121,AP
ANDHRA PRADESH,2002,Service (Private),0,248,248,126,7,629,0,44,24,15,4,87,716,AP
ANDHRA PRADESH,2002,Public Sector Undertaking,0,32,47,45,3,127,0,14,13,3,4,34,161,AP
ANDHRA PRADESH,2002,Student,48,238,15,2,0,303,72,134,2,0,0,208,511,AP
ANDHRA PRADESH,2002,Unemployed,0,276,283,115,0,674,0,114,37,18,0,169,843,AP
ANDHRA PRADESH,2002,Self-employed (Business activity),12,142,272,224,58,708,10,9,41,20,9,89,797,AP
ANDHRA PRADESH,2002,Professional Activity,0,74,129,124,45,372,0,7,18,24,5,54,426,AP
ANDHRA PRADESH,2002,Farming/Agriculture Activity,2,448,609,443,127,1629,2,85,119,53,8,267,1896,AP
ANDHRA PRADESH,2002,Retired Person,0,0,3,16,17,36,0,0,0,0,0,0,36,AP
ANDHRA PRADESH,2002,Total,101,2173,2831,1935,531,7571,139,1804,1374,572,233,4122,11693,AP
ANDHRA PRADESH,2002,Total Salaried,0,299,351,196,10,856,0,64,47,23,8,142,998,AP
ANDHRA PRADESH,2002,Total Self-employed,35,956,1412,1099,351,3853,19,194,309,168,72,762,4615,AP
ARUNACHAL PRADESH,2002,Others (Please Specify),0,0,0,0,0,0,0,0,0,0,0,0,0,AR
ARUNACHAL PRADESH,2002,House Wife,0,0,0,0,0,0,0,14,11,1,1,27,27,AR
ARUNACHAL PRADESH,2002,Service (Government),0,5,9,1,0,15,0,0,0,0,0,0,15,AR
ARUNACHAL PRADESH,2002,Service (Private),0,2,9,2,0,13,0,0,0,0,0,0,13,AR
ARUNACHAL PRADESH,2002,Public Sector Undertaking,0,0,0,0,0,0,0,0,0,0,0,0,0,AR
ARUNACHAL PRADESH,2002,Student,1,3,0,0,0,4,1,4,0,0,0,5,9,AR
ARUNACHAL PRADESH,2002,Unemployed,0,1,0,1,0,2,0,4,0,0,0,4,6,AR
ARUNACHAL PRADESH,2002,Self-employed (Business activity),0,4,7,3,0,14,0,1,0,0,0,1,15,AR
ARUNACHAL PRADESH,2002,Professional Activity,0,0,1,0,0,1,0,0,0,0,0,0,1,AR
ARUNACHAL PRADESH,2002,Farming/Agriculture Activity,0,5,12,1,3,21,1,5,0,0,0,6,27,AR
ARUNACHAL PRADESH,2002,Retired Person,0,0,0,1,0,1,0,0,0,0,0,0,1,AR
ARUNACHAL PRADESH,2002,Total,1,20,38,9,3,71,2,28,11,1,1,43,114,AR
ARUNACHAL PRADESH,2002,Total Salaried,0,7,18,3,0,28,0,0,0,0,0,0,28,AR
ARUNACHAL PRADESH,2002,Total Self-employed,0,9,20,4,3,36,1,6,0,0,0,7,43,AR
ASSAM,2002,Others (Please Specify),16,215,255,173,32,691,14,82,69,25,6,196,887,AS
ASSAM,2002,House Wife,0,0,0,0,0,0,0,221,178,67,19,485,485,AS
ASSAM,2002,Service (Government),0,4,4,6,0,14,0,1,3,0,0,4,18,AS
ASSAM,2002,Service (Private),0,26,36,15,2,79,0,4,4,4,0,12,91,AS
ASSAM,2002,Public Sector Undertaking,0,25,20,17,2,64,0,5,2,1,0,8,72,AS
ASSAM,2002,Student,7,77,3,1,0,88,10,19,0,0,0,29,117,AS
ASSAM,2002,Unemployed,0,69,127,28,7,231,0,20,6,5,0,31,262,AS
ASSAM,2002,Self-employed (Business activity),0,73,106,60,0,239,0,11,6,3,0,20,259,AS
ASSAM,2002,Professional Activity,0,13,17,12,0,42,0,0,0,0,0,0,42,AS
ASSAM,2002,Farming/Agriculture Activity,0,62,112,69,5,248,0,13,7,3,0,23,271,AS
ASSAM,2002,Retired Person,0,0,0,0,6,6,0,0,0,0,0,0,6,AS
ASSAM,2002,Total,23,564,680,381,54,1702,24,376,275,108,25,808,2510,AS
ASSAM,2002,Total Salaried,0,55,60,38,4,157,0,10,9,5,0,24,181,AS
ASSAM,2002,Total Self-employed,6,286,386,268,20,966,5,80,53,26,2,166,1132,AS
BIHAR,2002,Others (Please Specify),18,79,60,45,12,214,6,51,31,12,1,101,315,BR
BIHAR,2002,House Wife,0,0,0,0,0,0,0,70,52,22,4,148,148,BR
BIHAR,2002,Service (Government),0,0,3,3,0,6,0,0,0,0,0,0,6,BR
BIHAR,2002,Service (Private),0,4,3,0,1,8,0,5,3,0,0,8,16,BR
BIHAR,2002,Public Sector Undertaking,0,0,0,1,0,1,0,0,0,0,0,0,1,BR
BIHAR,2002,Student,5,25,10,0,0,40,6,3,5,0,0,14,54,BR
BIHAR,2002,Unemployed,0,21,31,5,0,57,1,6,4,0,0,11,68,BR
BIHAR,2002,Self-employed (Business activity),0,8,12,6,0,26,0,0,0,0,0,0,26,BR
BIHAR,2002,Professional Activity,0,2,3,0,0,5,0,0,0,0,0,0,5,BR
BIHAR,2002,Farming/Agriculture Activity,0,18,40,8,2,68,0,10,1,1,0,12,80,BR
BIHAR,2002,Retired Person,0,0,0,0,1,1,0,0,0,0,0,0,1,BR
BIHAR,2002,Total,23,157,162,68,16,426,13,145,96,35,5,294,720,BR
BIHAR,2002,Total Salaried,0,4,6,4,1,15,0,5,3,0,0,8,23,BR
BIHAR,2002,Total Self-employed,0,42,81,29,4,156,0,21,5,4,0,30,186,BR
CHANDIGARH,2002,Others (Please Specify),0,16,12,1,0,29,0,3,1,0,0,4,33,CH
CHANDIGARH,2002,House Wife,0,0,0,0,0,0,0,13,5,1,2,21,21,CH
CHANDIGARH,2002,Service (Government),0,0,3,0,0,3,0,0,0,0,0,0,3,CH
CHANDIGARH,2002,Service (Private),0,0,10,2,0,12,0,0,1,0,0,1,13,CH
CHANDIGARH,2002,Public Sector Undertaking,0,0,0,0,0,0,0,0,0,0,0,0,0,CH
CHANDIGARH,2002,Student,0,5,0,0,0,5,0,4,0,0,0,4,9,CH
CHANDIGARH,2002,Unemployed,1,2,0,0,0,3,1,3,0,0,0,4,7,CH
CHANDIGARH,2002,Self-employed (Business activity),0,0,1,0,0,1,0,0,0,0,0,0,1,CH
CHANDIGARH,2002,Professional Activity,0,0,0,0,0,0,0,0,0,0,0,0,0,CH
CHANDIGARH,2002,Farming/Agriculture Activity,0,0,0,0,0,0,0,0,0,0,0,0,0,CH
CHANDIGARH,2002,Retired Person,0,0,0,0,0,0,0,0,0,0,0,0,0,CH
CHANDIGARH,2002,Total,1,23,26,3,0,53,1,23,7,1,2,34,87,CH
CHANDIGARH,2002,Total Salaried,0,0,13,2,0,15,0,0,1,0,0,1,16,CH
CHANDIGARH,2002,Total Self-employed,0,0,1,0,0,1,0,0,0,0,0,0,1,CH
CHHATTISGARH,2002,Others (Please Specify),46,208,342,213,110,919,42,150,112,64,35,403,1322,CG
CHHATTISGARH,2002,House Wife,0,0,0,0,0,0,2,271,210,76,26,585,585,CG
CHHATTISGARH,2002,Service (Government),0,6,34,12,0,52,0,5,7,0,0,12,64,CG
CHHATTISGARH,2002,Service (Private),1,29,56,23,1,110,0,6,5,0,3,14,124,CG
CHHATTISGARH,2002,Public Sector Undertaking,0,17,33,22,9,81,0,3,5,2,0,10,91,CG
CHHATTISGARH,2002,Student,29,87,4,2,0,122,18,51,0,0,0,69,191,CG
CHHATTISGARH,2002,Unemployed,1,97,59,18,4,179,0,25,8,0,0,33,212,CG
CHHATTISGARH,2002,Self-employed (Business activity),0,22,30,11,1,64,0,0,0,0,0,0,64,CG
CHHATTISGARH,2002,Professional Activity,0,17,13,9,2,41,0,9,2,0,0,11,52,CG
CHHATTISGARH,2002,Farming/Agriculture Activity,8,311,357,296,82,1054,0,74,61,40,9,184,1238,CG
CHHATTISGARH,2002,Retired Person,0,0,0,0,7,7,0,0,0,0,0,0,7,CG
CHHATTISGARH,2002,Total,85,794,928,606,216,2629,62,594,410,182,73,1321,3950,CG
CHHATTISGARH,2002,Total Salaried,1,52,123,57,10,243,0,14,17,2,3,36,279,CG
CHHATTISGARH,2002,Total Self-employed,30,419,569,427,123,1568,5,141,130,76,28,380,1948,CG
D & N HAVELI,2002,Others (Please Specify),0,2,3,0,0,5,0,0,0,0,0,0,5,DN
D & N HAVELI,2002,House Wife,0,0,0,0,0,0,0,9,2,2,2,15,15,DN
D & N HAVELI,2002,Service (Government),0,1,0,0,0,1,0,0,0,0,0,0,1,DN
D & N HAVELI,2002,Service (Private),0,2,0,2,0,4,0,0,0,0,0,0,4,DN
D & N HAVELI,2002,Public Sector Undertaking,0,0,0,0,0,0,0,0,0,0,0,0,0,DN
D & N HAVELI,2002,Student,1,0,0,0,0,1,0,2,1,0,0,3,4,DN
D & N HAVELI,2002,Unemployed,0,0,0,0,0,0,0,0,0,0,0,0,0,DN
D & N HAVELI,2002,Self-employed (Business activity),0,0,0,0,0,0,0,0,0,0,0,0,0,DN
D & N HAVELI,2002,Professional Activity,0,0,0,0,0,0,0,0,0,0,0,0,0,DN
D & N HAVELI,2002,Farming/Agriculture Activity,0,4,5,7,5,21,0,0,0,0,0,0,21,DN
D & N HAVELI,2002,Retired Person,0,0,0,0,0,0,0,0,0,0,0,0,0,DN
D & N HAVELI,2002,Total,1,9,8,9,5,32,0,11,3,2,2,18,50,DN
D & N HAVELI,2002,Total Salaried,0,3,0,2,0,5,0,0,0,0,0,0,5,DN
D & N HAVELI,2002,Total Self-employed,0,6,8,7,5,26,0,0,0,0,0,0,26,DN
DAMAN & DIU,2002,Others (Please Specify),0,0,1,1,1,3,0,0,0,0,0,0,3,DD
DAMAN & DIU,2002,House Wife,0,0,0,0,0,0,0,1,1,0,0,2,2,DD
DAMAN & DIU,2002,Service (Government),0,0,0,0,0,0,0,0,0,0,0,0,0,DD
DAMAN & DIU,2002,Service (Private),0,3,6,0,0,9,0,0,0,0,0,0,9,DD
DAMAN & DIU,2002,Public Sector Undertaking,0,0,0,0,0,0,0,0,0,0,0,0,0,DD
DAMAN & DIU,2002,Student,0,0,0,0,0,0,0,0,0,0,0,0,0,DD
DAMAN & DIU,2002,Unemployed,0,0,1,0,0,1,0,0,0,0,0,0,1,DD
DAMAN & DIU,2002,Self-employed (Business activity),0,0,0,0,0,0,0,0,0,0,0,0,0,DD
DAMAN & DIU,2002,Professional Activity,0,0,0,0,0,0,0,0,0,0,0,0,0,DD
DAMAN & DIU,2002,Farming/Agriculture Activity,0,1,1,0,0,2,0,0,0,0,0,0,2,DD
DAMAN & DIU,2002,Retired Person,0,0,0,0,0,0,0,0,0,0,0,0,0,DD
DAMAN & DIU,2002,Total,0,4,9,1,1,15,0,1,1,0,0,2,17,DD
DAMAN & DIU,2002,Total Salaried,0,3,6,0,0,9,0,0,0,0,0,0,9,DD
DAMAN & DIU,2002,Total Self-employed,0,1,1,0,0,2,0,0,0,0,0,0,2,DD
DELHI (UT),2002,Others (Please Specify),4,44,50,19,0,117,1,22,17,6,2,48,165,DL
DELHI (UT),2002,House Wife,0,0,0,0,0,0,0,139,93,16,2,250,250,DL
DELHI (UT),2002,Service (Government),0,12,10,4,0,26,0,6,0,0,0,6,32,DL
DELHI (UT),2002,Service (Private),0,49,53,20,0,122,0,8,6,0,0,14,136,DL
DELHI (UT),2002,Public Sector Undertaking,0,1,5,3,0,9,0,0,0,0,0,0,9,DL
DELHI (UT),2002,Student,10,37,0,0,0,47,14,37,7,0,0,58,105,DL
DELHI (UT),2002,Unemployed,1,132,69,26,5,233,1,22,3,1,0,27,260,DL
DELHI (UT),2002,Self-employed (Business activity),0,18,16,7,1,42,0,4,0,0,0,4,46,DL
DELHI (UT),2002,Professional Activity,0,3,3,5,0,11,0,0,0,0,0,0,11,DL
DELHI (UT),2002,Farming/Agriculture Activity,0,5,11,8,6,30,0,3,0,0,0,3,33,DL
DELHI (UT),2002,Retired Person,0,0,1,1,4,6,0,0,0,0,0,0,6,DL
DELHI (UT),2002,Total,15,301,218,93,16,643,16,241,126,23,4,410,1053,DL
DELHI (UT),2002,Total Salaried,0,62,68,27,0,157,0,14,6,0,0,20,177,DL
DELHI (UT),2002,Total Self-employed,4,63,66,36,7,176,0,21,15,6,2,44,220,DL
GOA,2002,Others (Please Specify),0,19,24,11,9,63,0,7,3,1,0,11,74,GA
GOA,2002,House Wife,0,0,0,0,0,0,0,17,13,6,6,42,42,GA
GOA,2002,Service (Government),0,0,2,2,0,4,0,0,3,0,0,3,7,GA
GOA,2002,Service (Private),0,21,25,9,0,55,0,3,4,1,0,8,63,GA
GOA,2002,Public Sector Undertaking,0,0,3,1,0,4,0,0,0,0,0,0,4,GA
GOA,2002,Student,0,8,0,0,0,8,2,7,0,0,0,9,17,GA
GOA,2002,Unemployed,0,21,26,15,3,65,0,5,2,1,0,8,73,GA
GOA,2002,Self-employed (Business activity),0,2,6,3,0,11,0,0,0,0,0,0,11,GA
GOA,2002,Professional Activity,0,0,0,1,1,2,0,0,0,0,0,0,2,GA
GOA,2002,Farming/Agriculture Activity,0,2,4,3,0,9,0,1,1,0,0,2,11,GA
GOA,2002,Retired Person,0,0,0,1,4,5,0,0,0,0,0,0,5,GA
GOA,2002,Total,0,73,90,46,17,226,2,40,26,9,6,83,309,GA
GOA,2002,Total Salaried,0,21,30,12,0,63,0,3,7,1,0,11,74,GA
GOA,2002,Total Self-employed,0,6,17,11,5,39,0,1,1,0,0,2,41,GA
GUJARAT,2002,Others (Please Specify),7,181,172,113,36,509,8,45,26,28,8,115,624,GJ
GUJARAT,2002,House Wife,0,0,0,0,0,0,2,698,508,191,62,1461,1461,GJ
GUJARAT,2002,Service (Government),0,10,12,18,0,40,0,3,0,0,0,3,43,GJ
GUJARAT,2002,Service (Private),0,108,155,46,8,317,0,18,8,7,0,33,350,GJ
GUJARAT,2002,Public Sector Undertaking,0,24,31,13,4,72,0,6,1,1,0,8,80,GJ
GUJARAT,2002,Student,16,127,12,0,0,155,26,85,3,0,0,114,269,GJ
GUJARAT,2002,Unemployed,1,192,169,92,13,467,1,30,18,8,2,59,526,GJ
GUJARAT,2002,Self-employed (Business activity),0,90,112,51,4,257,0,3,1,1,0,5,262,GJ
GUJARAT,2002,Professional Activity,1,117,125,93,8,344,0,15,1,3,0,19,363,GJ
GUJARAT,2002,Farming/Agriculture Activity,0,173,208,74,27,482,2,43,22,16,5,88,570,GJ
GUJARAT,2002,Retired Person,0,0,0,18,45,63,0,0,2,3,28,33,96,GJ
GUJARAT,2002,Total,25,1022,996,518,145,2706,39,946,590,258,105,1938,4644,GJ
GUJARAT,2002,Total Salaried,0,142,198,77,12,429,0,27,9,8,0,44,473,GJ
GUJARAT,2002,Total Self-employed,6,509,579,286,53,1433,6,94,41,37,8,186,1619,GJ
HARYANA,2002,Others (Please Specify),25,207,268,131,61,692,18,26,19,9,5,77,769,HR
HARYANA,2002,House Wife,0,0,0,0,0,0,1,198,131,31,10,371,371,HR
HARYANA,2002,Service (Government),0,18,28,20,0,66,0,9,13,9,0,31,97,HR
HARYANA,2002,Service (Private),0,66,107,31,4,208,0,26,9,0,0,35,243,HR
HARYANA,2002,Public Sector Undertaking,0,29,34,2,0,65,0,5,9,0,0,14,79,HR
HARYANA,2002,Student,10,69,20,0,0,99,1,55,2,0,0,58,157,HR
HARYANA,2002,Unemployed,1,67,73,51,2,194,0,2,7,2,0,11,205,HR
HARYANA,2002,Self-employed (Business activity),0,13,15,9,2,39,0,0,0,0,0,0,39,HR
HARYANA,2002,Professional Activity,0,9,11,9,3,32,0,1,0,0,0,1,33,HR
HARYANA,2002,Farming/Agriculture Activity,0,52,66,40,9,167,0,15,6,0,2,23,190,HR
HARYANA,2002,Retired Person,0,0,1,3,4,8,0,0,7,2,0,9,17,HR
HARYANA,2002,Total,36,530,623,296,85,1570,20,337,203,53,17,630,2200,HR
HARYANA,2002,Total Salaried,0,113,169,53,4,339,0,40,31,9,0,80,419,HR
HARYANA,2002,Total Self-employed,13,153,159,102,30,457,2,19,10,2,2,35,492,HR
HIMACHAL PRADESH,2002,Others (Please Specify),2,30,22,15,3,72,0,15,5,1,0,21,93,HP
HIMACHAL PRADESH,2002,House Wife,0,0,0,0,0,0,2,46,29,5,1,83,83,HP
HIMACHAL PRADESH,2002,Service (Government),0,3,6,2,0,11,0,1,1,0,0,2,13,HP
HIMACHAL PRADESH,2002,Service (Private),0,6,5,1,0,12,0,0,0,0,0,0,12,HP
HIMACHAL PRADESH,2002,Public Sector Undertaking,0,2,1,1,0,4,0,0,0,1,0,1,5,HP
HIMACHAL PRADESH,2002,Student,2,16,1,0,0,19,1,11,0,0,0,12,31,HP
HIMACHAL PRADESH,2002,Unemployed,0,11,6,7,1,25,0,3,1,0,0,4,29,HP
HIMACHAL PRADESH,2002,Self-employed (Business activity),0,12,17,0,0,29,0,0,0,0,1,1,30,HP
HIMACHAL PRADESH,2002,Professional Activity,0,0,12,0,0,12,0,0,1,0,0,1,13,HP
HIMACHAL PRADESH,2002,Farming/Agriculture Activity,0,7,12,3,2,24,0,0,0,1,0,1,25,HP
HIMACHAL PRADESH,2002,Retired Person,0,0,0,0,0,0,0,0,0,0,0,0,0,HP
HIMACHAL PRADESH,2002,Total,4,87,82,29,6,208,3,76,37,8,2,126,334,HP
HIMACHAL PRADESH,2002,Total Salaried,0,11,12,4,0,27,0,1,1,1,0,3,30,HP
HIMACHAL PRADESH,2002,Total Self-employed,0,27,45,8,3,83,0,1,1,1,1,4,87,HP
JAMMU & KASHMIR,2002,Others (Please Specify),0,11,13,10,2,36,0,15,8,3,0,26,62,JK
JAMMU & KASHMIR,2002,House Wife,0,0,0,0,0,0,0,39,11,3,0,53,53,JK
JAMMU & KASHMIR,2002,Service (Government),0,2,8,1,0,11,0,0,0,0,0,0,11,JK
JAMMU & KASHMIR,2002,Service (Private),0,3,3,1,1,8,0,0,0,0,0,0,8,JK
JAMMU & KASHMIR,2002,Public Sector Undertaking,0,1,1,0,0,2,0,0,0,0,0,0,2,JK
JAMMU & KASHMIR,2002,Student,1,3,3,1,0,8,0,3,1,0,0,4,12,JK
JAMMU & KASHMIR,2002,Unemployed,3,9,4,0,0,16,0,3,1,0,0,4,20,JK
JAMMU & KASHMIR,2002,Self-employed (Business activity),0,0,0,0,0,0,0,0,0,0,0,0,0,JK
JAMMU & KASHMIR,2002,Professional Activity,0,0,0,0,0,0,0,0,0,0,0,0,0,JK
JAMMU & KASHMIR,2002,Farming/Agriculture Activity,0,9,4,1,1,15,0,1,0,0,0,1,16,JK
JAMMU & KASHMIR,2002,Retired Person,0,0,0,0,0,0,0,0,0,0,0,0,0,JK
JAMMU & KASHMIR,2002,Total,4,38,36,14,4,96,0,61,21,6,0,88,184,JK
JAMMU & KASHMIR,2002,Total Salaried,0,6,12,2,1,21,0,0,0,0,0,0,21,JK
JAMMU & KASHMIR,2002,Total Self-employed,0,16,12,9,2,39,0,8,7,3,0,18,57,JK
JHARKHAND,2002,Others (Please Specify),6,23,21,17,9,76,4,15,8,17,0,44,120,JH
JHARKHAND,2002,House Wife,0,0,0,0,0,0,0,28,25,10,0,63,63,JH
JHARKHAND,2002,Service (Government),0,0,0,0,0,0,0,0,0,0,0,0,0,JH
JHARKHAND,2002,Service (Private),0,0,4,1,0,5,0,0,3,0,0,3,8,JH
JHARKHAND,2002,Public Sector Undertaking,0,0,2,1,0,3,0,0,2,1,0,3,6,JH
JHARKHAND,2002,Student,3,4,0,0,0,7,0,3,0,0,0,3,10,JH
JHARKHAND,2002,Unemployed,0,8,8,11,0,27,0,1,1,0,0,2,29,JH
JHARKHAND,2002,Self-employed (Business activity),0,0,2,1,0,3,0,0,1,0,0,1,4,JH
JHARKHAND,2002,Professional Activity,0,4,1,2,2,9,0,0,0,0,0,0,9,JH
JHARKHAND,2002,Farming/Agriculture Activity,0,4,14,3,0,21,0,0,0,0,0,0,21,JH
JHARKHAND,2002,Retired Person,0,2,0,0,0,2,0,0,0,0,0,0,2,JH
JHARKHAND,2002,Total,9,45,52,36,11,153,4,47,40,28,0,119,272,JH
JHARKHAND,2002,Total Salaried,0,0,6,2,0,8,0,0,5,1,0,6,14,JH
JHARKHAND,2002,Total Self-employed,0,26,27,12,2,67,0,10,1,2,0,13,80,JH
KARNATAKA,2002,Others (Please Specify),55,791,1162,705,405,3118,55,414,262,123,119,973,4091,KA
KARNATAKA,2002,House Wife,0,0,0,0,0,0,6,914,776,347,182,2225,2225,KA
KARNATAKA,2002,Service (Government),0,41,86,59,0,186,0,14,14,5,1,34,220,KA
KARNATAKA,2002,Service (Private),2,272,325,228,61,888,9,80,59,28,3,179,1067,KA
KARNATAKA,2002,Public Sector Undertaking,0,51,87,42,3,183,0,21,3,0,0,24,207,KA
KARNATAKA,2002,Student,49,194,12,0,0,255,118,120,16,0,0,254,509,KA
KARNATAKA,2002,Unemployed,8,203,191,101,40,543,7,82,13,2,4,108,651,KA
KARNATAKA,2002,Self-employed (Business activity),2,186,323,176,68,755,1,24,13,1,0,39,794,KA
KARNATAKA,2002,Professional Activity,0,32,46,10,4,92,0,6,1,0,0,7,99,KA
KARNATAKA,2002,Farming/Agriculture Activity,5,515,799,498,191,2008,8,121,125,55,23,332,2340,KA
KARNATAKA,2002,Retired Person,0,0,0,13,39,52,0,0,0,7,8,15,67,KA
KARNATAKA,2002,Total,121,2285,3031,1832,811,8080,204,1796,1282,568,340,4190,12270,KA
KARNATAKA,2002,Total Salaried,2,364,498,329,64,1257,9,115,76,33,4,237,1494,KA
KARNATAKA,2002,Total Self-employed,34,1354,2116,1198,579,5281,44,425,301,121,90,981,6262,KA
KERALA,2002,Others (Please Specify),22,393,697,666,522,2300,23,100,151,81,89,444,2744,KL
KERALA,2002,House Wife,0,0,0,0,0,0,0,295,504,409,245,1453,1453,KL
KERALA,2002,Service (Government),0,19,67,64,2,152,0,6,5,7,2,20,172,KL
KERALA,2002,Service (Private),0,96,148,115,38,397,1,25,27,20,3,76,473,KL
KERALA,2002,Public Sector Undertaking,0,13,35,39,9,96,0,6,10,3,2,21,117,KL
KERALA,2002,Student,32,112,2,0,0,146,41,95,0,0,0,136,282,KL
KERALA,2002,Unemployed,0,340,473,357,429,1599,0,137,94,65,44,340,1939,KL
KERALA,2002,Self-employed (Business activity),0,94,231,222,84,631,0,0,7,6,3,16,647,KL
KERALA,2002,Professional Activity,0,63,112,78,38,291,0,8,10,3,1,22,313,KL
KERALA,2002,Farming/Agriculture Activity,0,134,426,614,259,1433,0,17,32,27,24,100,1533,KL
KERALA,2002,Retired Person,0,0,5,22,93,120,0,0,0,4,13,17,137,KL
KERALA,2002,Total,54,1264,2196,2177,1474,7165,65,689,840,625,426,2645,9810,KL
KERALA,2002,Total Salaried,0,128,250,218,49,645,1,37,42,30,7,117,762,KL
KERALA,2002,Total Self-employed,4,513,1153,1260,615,3545,0,71,122,87,70,350,3895,KL
LAKSHADWEEP,2002,Others (Please Specify),0,0,0,0,0,0,0,0,0,0,0,0,0,LD
LAKSHADWEEP,2002,House Wife,0,0,0,0,0,0,0,0,0,0,0,0,0,LD
LAKSHADWEEP,2002,Service (Government),0,0,0,0,0,0,0,0,0,0,0,0,0,LD
LAKSHADWEEP,2002,Service (Private),0,0,0,0,0,0,0,0,0,0,0,0,0,LD
LAKSHADWEEP,2002,Public Sector Undertaking,0,0,0,0,0,0,0,0,0,0,0,0,0,LD
LAKSHADWEEP,2002,Student,0,0,0,0,0,0,0,0,0,0,0,0,0,LD
LAKSHADWEEP,2002,Unemployed,0,0,0,0,0,0,0,0,0,0,0,0,0,LD
LAKSHADWEEP,2002,Self-employed (Business activity),0,0,0,0,0,0,0,0,0,0,0,0,0,LD
LAKSHADWEEP,2002,Professional Activity,0,0,0,0,0,0,0,0,0,0,0,0,0,LD
LAKSHADWEEP,2002,Farming/Agriculture Activity,0,0,0,0,0,0,0,0,0,0,0,0,0,LD
LAKSHADWEEP,2002,Retired Person,0,0,0,0,0,0,0,0,0,0,0,0,0,LD
LAKSHADWEEP,2002,Total,0,0,0,0,0,0,0,0,0,0,0,0,0,LD
LAKSHADWEEP,2002,Total Salaried,0,0,0,0,0,0,0,0,0,0,0,0,0,LD
LAKSHADWEEP,2002,Total Self-employed,0,0,0,0,0,0,0,0,0,0,0,0,0,LD
MADHYA PRADESH,2002,Others (Please Specify),35,294,297,220,112,958,44,150,107,44,20,365,1323,MP
MADHYA PRADESH,2002,House Wife,0,0,0,0,0,0,7,1362,577,225,116,2287,2287,MP
MADHYA PRADESH,2002,Service (Government),0,80,67,37,6,190,0,12,13,3,0,28,218,MP
MADHYA PRADESH,2002,Service (Private),0,184,129,58,5,376,0,30,25,4,0,59,435,MP
MADHYA PRADESH,2002,Public Sector Undertaking,0,62,30,3,0,95,0,11,7,5,0,23,118,MP
MADHYA PRADESH,2002,Student,52,151,12,0,0,215,35,87,0,0,0,122,337,MP
MADHYA PRADESH,2002,Unemployed,3,163,84,25,0,275,0,24,15,4,0,43,318,MP
MADHYA PRADESH,2002,Self-employed (Business activity),0,107,101,65,20,293,0,26,22,11,11,70,363,MP
MADHYA PRADESH,2002,Professional Activity,0,28,48,21,11,108,0,0,9,11,4,24,132,MP
MADHYA PRADESH,2002,Farming/Agriculture Activity,2,386,350,203,100,1041,4,163,86,35,11,299,1340,MP
MADHYA PRADESH,2002,Retired Person,0,0,0,1,27,28,0,0,0,0,0,0,28,MP
MADHYA PRADESH,2002,Total,92,1455,1118,633,281,3579,90,1865,861,342,162,3320,6899,MP
MADHYA PRADESH,2002,Total Salaried,0,326,226,98,11,661,0,53,45,12,0,110,771,MP
MADHYA PRADESH,2002,Total Self-employed,28,753,739,481,229,2230,40,306,199,96,43,684,2914,MP
MAHARASHTRA,2002,Others (Please Specify),22,583,975,477,322,2379,17,164,123,51,30,385,2764,MH
MAHARASHTRA,2002,House Wife,0,0,0,0,0,0,0,1762,1091,362,200,3415,3415,MH
MAHARASHTRA,2002,Service (Government),0,43,123,54,0,220,0,14,11,3,0,28,248,MH
MAHARASHTRA,2002,Service (Private),0,319,554,256,37,1166,0,50,54,20,7,131,1297,MH
MAHARASHTRA,2002,Public Sector Undertaking,0,32,41,30,0,103,0,3,3,1,0,7,110,MH
MAHARASHTRA,2002,Student,77,367,4,0,0,448,86,286,6,0,0,378,826,MH
MAHARASHTRA,2002,Unemployed,0,390,355,149,2,896,7,66,27,2,0,102,998,MH
MAHARASHTRA,2002,Self-employed (Business activity),0,94,214,135,77,520,0,26,19,4,3,52,572,MH
MAHARASHTRA,2002,Professional Activity,0,148,170,61,28,407,0,5,14,6,3,28,435,MH
MAHARASHTRA,2002,Farming/Agriculture Activity,3,868,1229,669,386,3155,0,269,134,86,51,540,3695,MH
MAHARASHTRA,2002,Retired Person,0,0,5,35,113,153,0,0,1,3,12,16,169,MH
MAHARASHTRA,2002,Total,102,2844,3670,1866,965,9447,110,2645,1483,538,306,5082,14529,MH
MAHARASHTRA,2002,Total Salaried,0,394,718,340,37,1489,0,67,68,24,7,166,1655,MH
MAHARASHTRA,2002,Total Self-employed,24,1648,2494,1304,769,6239,13,461,285,139,80,978,7217,MH
MANIPUR,2002,Others (Please Specify),0,0,0,1,0,1,0,0,0,1,0,1,2,MN
MANIPUR,2002,House Wife,0,0,0,0,0,0,0,3,0,0,0,3,3,MN
MANIPUR,2002,Service (Government),0,0,3,1,0,4,0,0,0,0,0,0,4,MN
MANIPUR,2002,Service (Private),0,0,0,0,0,0,0,0,0,0,0,0,0,MN
MANIPUR,2002,Public Sector Undertaking,0,0,2,1,1,4,0,0,0,0,0,0,4,MN
MANIPUR,2002,Student,0,7,0,0,0,7,0,3,0,0,0,3,10,MN
MANIPUR,2002,Unemployed,0,2,2,6,1,11,0,1,1,0,0,2,13,MN
MANIPUR,2002,Self-employed (Business activity),0,0,0,0,0,0,0,0,0,0,0,0,0,MN
MANIPUR,2002,Professional Activity,0,0,0,0,0,0,0,0,0,0,0,0,0,MN
MANIPUR,2002,Farming/Agriculture Activity,0,0,1,0,2,3,0,0,0,0,0,0,3,MN
MANIPUR,2002,Retired Person,0,0,0,0,0,0,0,0,0,0,0,0,0,MN
MANIPUR,2002,Total,0,9,8,9,4,30,0,7,1,1,0,9,39,MN
MANIPUR,2002,Total Salaried,0,0,5,2,1,8,0,0,0,0,0,0,8,MN
MANIPUR,2002,Total Self-employed,0,0,1,0,2,3,0,0,0,0,0,0,3,MN
MEGHALAYA,2002,Others (Please Specify),0,2,7,6,3,18,1,0,1,0,0,2,20,ML
MEGHALAYA,2002,House Wife,0,0,0,0,0,0,0,6,3,2,0,11,11,ML
MEGHALAYA,2002,Service (Government),0,0,4,0,0,4,0,0,0,0,0,0,4,ML
MEGHALAYA,2002,Service (Private),0,1,3,0,0,4,0,0,0,0,0,0,4,ML
MEGHALAYA,2002,Public Sector Undertaking,0,0,0,0,0,0,0,0,0,0,0,0,0,ML
MEGHALAYA,2002,Student,2,0,0,0,0,2,1,0,0,0,0,1,3,ML
MEGHALAYA,2002,Unemployed,0,3,5,2,0,10,0,2,2,0,0,4,14,ML
MEGHALAYA,2002,Self-employed (Business activity),0,1,0,2,0,3,0,0,0,0,0,0,3,ML
MEGHALAYA,2002,Professional Activity,0,0,0,0,0,0,0,0,0,0,0,0,0,ML
MEGHALAYA,2002,Farming/Agriculture Activity,1,2,2,3,0,8,0,0,0,0,0,0,8,ML
MEGHALAYA,2002,Retired Person,0,0,0,0,0,0,0,0,0,0,0,0,0,ML
MEGHALAYA,2002,Total,3,9,21,13,3,49,2,8,6,2,0,18,67,ML
MEGHALAYA,2002,Total Salaried,0,1,7,0,0,8,0,0,0,0,0,0,8,ML
MEGHALAYA,2002,Total Self-employed,1,5,6,8,3,23,0,0,0,0,0,0,23,ML
MIZORAM,2002,Others (Please Specify),0,9,9,1,2,21,0,2,1,1,0,4,25,MZ
MIZORAM,2002,House Wife,0,0,0,0,0,0,0,2,1,2,0,5,5,MZ
MIZORAM,2002,Service (Government),0,3,2,3,0,8,0,0,0,0,0,0,8,MZ
MIZORAM,2002,Service (Private),0,0,0,0,0,0,0,0,0,0,0,0,0,MZ
MIZORAM,2002,Public Sector Undertaking,0,0,3,1,0,4,0,0,0,0,0,0,4,MZ
MIZORAM,2002,Student,0,1,0,0,0,1,0,0,0,0,0,0,1,MZ
MIZORAM,2002,Unemployed,0,14,3,2,0,19,0,1,0,0,0,1,20,MZ
MIZORAM,2002,Self-employed (Business activity),0,0,0,0,0,0,0,0,0,0,0,0,0,MZ
MIZORAM,2002,Professional Activity,0,0,0,0,0,0,0,0,0,0,0,0,0,MZ
MIZORAM,2002,Farming/Agriculture Activity,0,0,2,1,0,3,0,0,0,0,0,0,3,MZ
MIZORAM,2002,Retired Person,0,0,0,0,0,0,0,0,0,0,0,0,0,MZ
MIZORAM,2002,Total,0,27,19,8,2,56,0,5,2,3,0,10,66,MZ
MIZORAM,2002,Total Salaried,0,3,5,4,0,12,0,0,0,0,0,0,12,MZ
MIZORAM,2002,Total Self-employed,0,6,11,2,2,21,0,2,1,1,0,4,25,MZ
NAGALAND,2002,Others (Please Specify),0,0,2,1,0,3,1,0,0,0,0,1,4,NG
NAGALAND,2002,House Wife,0,0,0,0,0,0,0,2,1,0,0,3,3,NG
NAGALAND,2002,Service (Government),0,2,8,0,0,10,0,0,0,0,0,0,10,NG
NAGALAND,2002,Service (Private),0,0,1,0,0,1,0,0,0,0,0,0,1,NG
NAGALAND,2002,Public Sector Undertaking,0,0,0,0,0,0,0,0,0,0,0,0,0,NG
NAGALAND,2002,Student,1,0,0,0,0,1,1,1,1,0,0,3,4,NG
NAGALAND,2002,Unemployed,0,0,3,0,0,3,0,0,1,0,0,1,4,NG
NAGALAND,2002,Self-employed (Business activity),0,0,1,0,0,1,0,0,0,0,0,0,1,NG
NAGALAND,2002,Professional Activity,0,0,0,0,0,0,0,0,0,0,0,0,0,NG
NAGALAND,2002,Farming/Agriculture Activity,0,0,0,0,0,0,0,0,0,0,0,0,0,NG
NAGALAND,2002,Retired Person,0,0,0,0,0,0,0,0,0,0,0,0,0,NG
NAGALAND,2002,Total,1,2,15,1,0,19,2,3,3,0,0,8,27,NG
NAGALAND,2002,Total Salaried,0,2,9,0,0,11,0,0,0,0,0,0,11,NG
NAGALAND,2002,Total Self-employed,0,0,3,1,0,4,1,0,0,0,0,1,5,NG
ODISHA,2002,Others (Please Specify),28,341,374,228,83,1054,41,223,133,87,25,509,1563,OD
ODISHA,2002,House Wife,0,0,0,0,0,0,0,328,274,125,43,770,770,OD
ODISHA,2002,Service (Government),0,13,14,20,0,47,0,18,22,10,1,51,98,OD
ODISHA,2002,Service (Private),6,105,123,93,16,343,0,24,19,8,0,51,394,OD
ODISHA,2002,Public Sector Undertaking,0,21,44,55,4,124,0,10,16,14,0,40,164,OD
ODISHA,2002,Student,19,112,20,8,0,159,27,90,2,1,0,120,279,OD
ODISHA,2002,Unemployed,2,135,151,59,5,352,1,73,76,8,1,159,511,OD
ODISHA,2002,Self-employed (Business activity),0,35,76,58,4,173,0,5,5,1,0,11,184,OD
ODISHA,2002,Professional Activity,0,11,20,21,4,56,0,3,1,0,0,4,60,OD
ODISHA,2002,Farming/Agriculture Activity,0,79,123,69,38,309,0,9,14,10,3,36,345,OD
ODISHA,2002,Retired Person,0,0,0,3,11,14,0,0,4,2,0,6,20,OD
ODISHA,2002,Total,55,852,945,614,165,2631,69,783,566,266,73,1757,4388,OD
ODISHA,2002,Total Salaried,6,139,181,168,20,514,0,52,57,32,1,142,656,OD
ODISHA,2002,Total Self-employed,18,369,451,306,112,1256,29,185,103,84,22,423,1679,OD
PUDUCHERRY,2002,Others (Please Specify),0,5,9,8,2,24,0,0,0,0,0,0,24,PY
PUDUCHERRY,2002,House Wife,0,0,0,0,0,0,0,35,34,22,12,103,103,PY
PUDUCHERRY,2002,Service (Government),0,3,5,9,1,18,0,0,1,0,0,1,19,PY
PUDUCHERRY,2002,Service (Private),0,48,84,54,17,203,0,7,2,0,1,10,213,PY
PUDUCHERRY,2002,Public Sector Undertaking,0,0,5,2,0,7,0,0,0,0,0,0,7,PY
PUDUCHERRY,2002,Student,5,8,0,0,0,13,3,12,0,0,0,15,28,PY
PUDUCHERRY,2002,Unemployed,0,18,11,2,9,40,0,19,1,0,0,20,60,PY
PUDUCHERRY,2002,Self-employed (Business activity),0,2,8,6,2,18,0,0,0,0,0,0,18,PY
PUDUCHERRY,2002,Professional Activity,0,0,0,0,0,0,0,0,0,0,0,0,0,PY
PUDUCHERRY,2002,Farming/Agriculture Activity,0,14,35,26,8,83,0,1,3,0,1,5,88,PY
PUDUCHERRY,2002,Retired Person,0,0,2,2,0,4,0,0,0,1,2,3,7,PY
PUDUCHERRY,2002,Total,5,98,159,109,39,410,3,74,41,23,16,157,567,PY
PUDUCHERRY,2002,Total Salaried,0,51,94,65,18,228,0,7,3,0,1,11,239,PY
PUDUCHERRY,2002,Total Self-employed,0,21,52,40,12,125,0,1,3,0,1,5,130,PY
PUNJAB,2002,Others (Please Specify),16,65,50,41,15,187,0,2,5,0,1,8,195,PN
PUNJAB,2002,House Wife,0,0,0,0,0,0,0,49,30,6,2,87,87,PN
PUNJAB,2002,Service (Government),0,8,8,3,0,19,0,0,0,0,0,0,19,PN
PUNJAB,2002,Service (Private),0,10,8,5,0,23,0,1,0,0,0,1,24,PN
PUNJAB,2002,Public Sector Undertaking,0,0,7,4,0,11,0,0,0,0,0,0,11,PN
PUNJAB,2002,Student,1,10,0,0,0,11,2,6,0,0,0,8,19,PN
PUNJAB,2002,Unemployed,0,19,13,8,1,41,0,4,0,0,0,4,45,PN
PUNJAB,2002,Self-employed (Business activity),0,12,18,8,2,40,0,2,0,0,0,2,42,PN
PUNJAB,2002,Professional Activity,0,10,11,1,0,22,0,0,0,0,0,0,22,PN
PUNJAB,2002,Farming/Agriculture Activity,0,16,14,1,9,40,0,0,0,0,0,0,40,PN
PUNJAB,2002,Retired Person,0,0,0,1,2,3,0,0,0,0,0,0,3,PN
PUNJAB,2002,Total,17,150,129,72,29,397,2,64,35,6,3,110,507,PN
PUNJAB,2002,Total Salaried,0,18,23,12,0,53,0,1,0,0,0,1,54,PN
PUNJAB,2002,Total Self-employed,0,72,76,38,26,212,0,2,2,0,0,4,216,PN
RAJASTHAN,2002,Others (Please Specify),41,288,352,150,49,880,23,86,57,10,3,179,1059,RJ
RAJASTHAN,2002,House Wife,0,0,0,0,0,0,1,387,248,113,18,767,767,RJ
RAJASTHAN,2002,Service (Government),0,12,36,14,0,62,0,0,2,0,0,2,64,RJ
RAJASTHAN,2002,Service (Private),0,75,73,71,2,221,0,15,13,2,0,30,251,RJ
RAJASTHAN,2002,Public Sector Undertaking,0,20,26,11,2,59,0,1,3,4,0,8,67,RJ
RAJASTHAN,2002,Student,22,56,9,0,0,87,6,46,0,0,0,52,139,RJ
RAJASTHAN,2002,Unemployed,1,58,41,26,2,128,0,9,6,1,0,16,144,RJ
RAJASTHAN,2002,Self-employed (Business activity),0,44,43,29,4,120,0,0,5,0,0,5,125,RJ
RAJASTHAN,2002,Professional Activity,0,10,9,5,1,25,0,1,0,0,0,1,26,RJ
RAJASTHAN,2002,Farming/Agriculture Activity,1,154,174,128,36,493,0,35,39,17,3,94,587,RJ
RAJASTHAN,2002,Retired Person,0,0,0,8,9,17,0,0,0,0,2,2,19,RJ
RAJASTHAN,2002,Total,65,717,763,442,105,2092,30,580,373,147,26,1156,3248,RJ
RAJASTHAN,2002,Total Salaried,0,107,135,96,4,342,0,16,18,6,0,40,382,RJ
RAJASTHAN,2002,Total Self-employed,37,363,372,248,61,1081,16,78,64,27,6,191,1272,RJ
SIKKIM,2002,Others (Please Specify),2,4,14,7,3,30,0,3,1,1,0,5,35,SK
SIKKIM,2002,House Wife,0,0,0,0,0,0,0,1,0,0,0,1,1,SK
SIKKIM,2002,Service (Government),0,0,0,0,0,0,0,0,0,0,0,0,0,SK
SIKKIM,2002,Service (Private),0,0,0,0,0,0,0,0,0,0,0,0,0,SK
SIKKIM,2002,Public Sector Undertaking,0,0,0,0,0,0,0,0,0,0,0,0,0,SK
SIKKIM,2002,Student,1,2,0,0,0,3,0,2,0,0,0,2,5,SK
SIKKIM,2002,Unemployed,0,4,3,2,1,10,1,3,4,2,2,12,22,SK
SIKKIM,2002,Self-employed (Business activity),0,0,0,1,2,3,0,0,0,1,0,1,4,SK
SIKKIM,2002,Professional Activity,0,0,0,0,0,0,0,0,0,0,0,0,0,SK
SIKKIM,2002,Farming/Agriculture Activity,0,2,2,1,0,5,0,2,0,1,0,3,8,SK
SIKKIM,2002,Retired Person,0,3,0,0,0,3,0,0,0,0,0,0,3,SK
SIKKIM,2002,Total,3,15,19,11,6,54,1,11,5,5,2,24,78,SK
SIKKIM,2002,Total Salaried,0,0,0,0,0,0,0,0,0,0,0,0,0,SK
SIKKIM,2002,Total Self-employed,2,6,9,5,5,27,0,5,0,3,0,8,35,SK
TAMIL NADU,2002,Others (Please Specify),48,538,785,516,295,2182,85,254,222,172,73,806,2988,TN
TAMIL NADU,2002,House Wife,0,0,0,0,0,0,0,951,741,343,103,2138,2138,TN
TAMIL NADU,2002,Service (Government),0,77,79,62,6,224,0,41,51,32,3,127,351,TN
TAMIL NADU,2002,Service (Private),0,226,378,206,18,828,4,147,67,48,21,287,1115,TN
TAMIL NADU,2002,Public Sector Undertaking,0,68,105,50,7,230,0,57,32,7,0,96,326,TN
TAMIL NADU,2002,Student,42,176,41,0,0,259,37,158,20,0,0,215,474,TN
TAMIL NADU,2002,Unemployed,8,342,381,277,58,1066,14,125,100,48,9,296,1362,TN
TAMIL NADU,2002,Self-employed (Business activity),0,160,298,288,29,775,0,19,24,17,1,61,836,TN
TAMIL NADU,2002,Professional Activity,0,35,65,24,3,127,0,8,7,3,0,18,145,TN
TAMIL NADU,2002,Farming/Agriculture Activity,1,371,420,370,95,1257,5,99,54,31,9,198,1455,TN
TAMIL NADU,2002,Retired Person,0,0,0,3,32,35,0,0,0,6,13,19,54,TN
TAMIL NADU,2002,Total,99,1993,2552,1796,543,6983,145,1859,1318,707,232,4261,11244,TN
TAMIL NADU,2002,Total Salaried,0,371,562,318,31,1282,4,245,150,87,24,510,1792,TN
TAMIL NADU,2002,Total Self-employed,13,876,1235,952,283,3359,53,285,185,137,63,723,4082,TN
TRIPURA,2002,Others (Please Specify),8,82,85,45,15,235,7,47,29,22,7,112,347,TR
TRIPURA,2002,House Wife,0,0,0,0,0,0,0,54,39,6,5,104,104,TR
TRIPURA,2002,Service (Government),0,5,10,8,0,23,0,5,4,2,0,11,34,TR
TRIPURA,2002,Service (Private),0,10,8,5,0,23,0,4,5,3,0,12,35,TR
TRIPURA,2002,Public Sector Undertaking,0,6,14,3,0,23,0,3,4,2,0,9,32,TR
TRIPURA,2002,Student,4,15,0,0,0,19,4,9,6,0,0,19,38,TR
TRIPURA,2002,Unemployed,1,22,21,9,0,53,2,2,1,0,0,5,58,TR
TRIPURA,2002,Self-employed (Business activity),0,15,13,13,5,46,0,0,0,0,0,0,46,TR
TRIPURA,2002,Professional Activity,0,10,16,10,4,40,0,0,0,0,0,0,40,TR
TRIPURA,2002,Farming/Agriculture Activity,0,8,12,7,0,27,1,3,4,3,3,14,41,TR
TRIPURA,2002,Retired Person,0,0,0,2,2,4,0,0,0,0,0,0,4,TR
TRIPURA,2002,Total,13,173,179,102,26,493,14,127,92,38,15,286,779,TR
TRIPURA,2002,Total Salaried,0,21,32,16,0,69,0,12,13,7,0,32,101,TR
TRIPURA,2002,Total Self-employed,4,70,78,52,20,224,3,14,10,8,4,39,263,TR
UTTAR PRADESH,2002,Others (Please Specify),32,241,262,221,102,858,171,161,139,74,39,584,1442,UP
UTTAR PRADESH,2002,House Wife,0,0,0,0,0,0,8,555,329,157,54,1103,1103,UP
UTTAR PRADESH,2002,Service (Government),0,7,10,3,1,21,0,4,5,0,0,9,30,UP
UTTAR PRADESH,2002,Service (Private),0,82,77,41,0,200,0,14,12,1,0,27,227,UP
UTTAR PRADESH,2002,Public Sector Undertaking,0,11,12,9,0,32,0,1,3,0,0,4,36,UP
UTTAR PRADESH,2002,Student,15,90,11,4,0,120,21,67,8,0,0,96,216,UP
UTTAR PRADESH,2002,Unemployed,1,216,168,53,14,452,4,21,6,2,0,33,485,UP
UTTAR PRADESH,2002,Self-employed (Business activity),0,44,52,15,19,130,0,5,1,1,0,7,137,UP
UTTAR PRADESH,2002,Professional Activity,0,10,7,8,4,29,0,3,3,0,0,6,35,UP
UTTAR PRADESH,2002,Farming/Agriculture Activity,7,152,165,107,40,471,4,28,15,5,2,54,525,UP
UTTAR PRADESH,2002,Retired Person,0,0,2,1,10,13,0,0,0,0,1,1,14,UP
UTTAR PRADESH,2002,Total,55,853,766,462,190,2326,208,859,521,240,96,1924,4250,UP
UTTAR PRADESH,2002,Total Salaried,0,100,99,53,1,253,0,19,20,1,0,40,293,UP
UTTAR PRADESH,2002,Total Self-employed,28,328,400,269,150,1175,171,146,123,65,30,535,1710,UP
UTTARAKHAND,2002,Others (Please Specify),5,34,19,15,9,82,6,10,3,1,0,20,102,UK
UTTARAKHAND,2002,House Wife,0,0,0,0,0,0,1,58,44,14,2,119,119,UK
UTTARAKHAND,2002,Service (Government),0,2,2,1,0,5,0,1,1,0,0,2,7,UK
UTTARAKHAND,2002,Service (Private),0,12,12,1,0,25,0,2,0,0,0,2,27,UK
UTTARAKHAND,2002,Public Sector Undertaking,0,1,0,0,0,1,0,0,0,0,0,0,1,UK
UTTARAKHAND,2002,Student,2,4,0,0,0,6,0,3,0,0,0,3,9,UK
UTTARAKHAND,2002,Unemployed,1,18,9,7,3,38,1,4,1,0,1,7,45,UK
UTTARAKHAND,2002,Self-employed (Business activity),0,5,3,0,0,8,0,0,0,0,0,0,8,UK
UTTARAKHAND,2002,Professional Activity,0,3,1,0,0,4,0,0,0,0,0,0,4,UK
UTTARAKHAND,2002,Farming/Agriculture Activity,0,10,14,3,4,31,0,2,1,0,0,3,34,UK
UTTARAKHAND,2002,Retired Person,0,0,0,5,0,5,0,0,0,0,0,0,5,UK
UTTARAKHAND,2002,Total,8,89,60,32,16,205,8,80,50,15,3,156,361,UK
UTTARAKHAND,2002,Total Salaried,0,15,14,2,0,31,0,3,1,0,0,4,35,UK
UTTARAKHAND,2002,Total Self-employed,2,50,37,16,13,118,6,12,4,1,0,23,141,UK
WEST BENGAL,2002,Others (Please Specify),150,755,947,578,228,2658,149,563,513,297,208,1730,4388,WB
WEST BENGAL,2002,House Wife,0,0,0,0,0,0,0,925,907,395,67,2294,2294,WB
WEST BENGAL,2002,Service (Government),0,20,64,59,5,148,0,21,35,49,1,106,254,WB
WEST BENGAL,2002,Service (Private),2,251,273,235,31,792,0,141,136,63,34,374,1166,WB
WEST BENGAL,2002,Public Sector Undertaking,0,173,96,110,27,406,0,72,86,54,1,213,619,WB
WEST BENGAL,2002,Student,127,251,20,1,0,399,144,118,6,0,0,268,667,WB
WEST BENGAL,2002,Unemployed,4,274,218,145,19,660,0,150,124,13,3,290,950,WB
WEST BENGAL,2002,Self-employed (Business activity),0,155,232,185,47,619,0,59,25,66,20,170,789,WB
WEST BENGAL,2002,Professional Activity,0,15,79,56,14,164,0,1,16,28,0,45,209,WB
WEST BENGAL,2002,Farming/Agriculture Activity,0,321,425,302,95,1143,1,108,140,119,7,375,1518,WB
WEST BENGAL,2002,Retired Person,0,0,0,40,95,135,0,0,0,0,18,18,153,WB
WEST BENGAL,2002,Total,283,2215,2354,1711,561,7124,294,2158,1988,1084,359,5883,13007,WB
WEST BENGAL,2002,Total Salaried,2,444,433,404,63,1346,0,234,257,166,36,693,2039,WB
WEST BENGAL,2002,Total Self-employed,32,838,1136,782,247,3035,41,391,359,349,97,1237,4272,WB
A & N ISLANDS,2003,Others (Please Specify),0,0,0,0,0,0,0,0,0,0,0,0,0,AN
A & N ISLANDS,2003,House Wife,0,0,0,0,0,0,0,17,8,2,1,28,28,AN
A & N ISLANDS,2003,Service (Government),0,0,7,6,1,14,0,1,0,0,0,1,15,AN
A & N ISLANDS,2003,Service (Private),0,17,13,10,2,42,0,0,0,0,0,0,42,AN
A & N ISLANDS,2003,Public Sector Undertaking,0,1,2,0,0,3,0,0,0,0,0,0,3,AN
A & N ISLANDS,2003,Student,1,1,0,0,0,2,4,4,0,0,0,8,10,AN
A & N ISLANDS,2003,Unemployed,0,3,1,0,2,6,0,6,0,0,0,6,12,AN
A & N ISLANDS,2003,Self-employed (Business activity),0,0,0,0,0,0,0,0,0,0,0,0,0,AN
A & N ISLANDS,2003,Professional Activity,0,0,0,0,0,0,0,0,0,0,0,0,0,AN
A & N ISLANDS,2003,Farming/Agriculture Activity,0,1,0,0,0,1,0,0,0,0,0,0,1,AN
A & N ISLANDS,2003,Retired Person,0,0,0,1,1,2,0,0,0,0,0,0,2,AN
A & N ISLANDS,2003,Total,1,23,23,17,6,70,4,28,8,2,1,43,113,AN
A & N ISLANDS,2003,Total Salaried,0,18,22,16,3,59,0,1,0,0,0,1,60,AN
A & N ISLANDS,2003,Total Self-employed,0,1,0,0,0,1,0,0,0,0,0,0,1,AN
ANDHRA PRADESH,2003,Others (Please Specify),74,1104,1184,697,213,3272,95,362,248,156,68,929,4201,AP
ANDHRA PRADESH,2003,House Wife,0,0,0,0,0,0,4,955,622,256,92,1929,1929,AP
ANDHRA PRADESH,2003,Service (Government),0,76,84,79,11,250,0,11,21,4,0,36,286,AP
ANDHRA PRADESH,2003,Service (Private),2,90,166,103,8,369,2,32,43,21,5,103,472,AP
ANDHRA PRADESH,2003,Public Sector Undertaking,0,20,48,37,16,121,0,20,21,11,3,55,176,AP
ANDHRA PRADESH,2003,Student,69,240,39,0,0,348,71,148,2,0,0,221,569,AP
ANDHRA PRADESH,2003,Unemployed,1,224,307,116,0,648,9,52,14,3,0,78,726,AP
ANDHRA PRADESH,2003,Self-employed (Business activity),2,87,238,222,47,596,9,18,49,27,5,108,704,AP
ANDHRA PRADESH,2003,Professional Activity,0,104,180,90,16,390,1,6,18,2,0,27,417,AP
ANDHRA PRADESH,2003,Farming/Agriculture Activity,7,325,585,376,149,1442,6,81,163,96,12,358,1800,AP
ANDHRA PRADESH,2003,Retired Person,0,0,15,25,37,77,0,0,3,33,16,52,129,AP
ANDHRA PRADESH,2003,Total,155,2270,2846,1745,497,7513,197,1685,1204,609,201,3896,11409,AP
ANDHRA PRADESH,2003,Total Salaried,2,186,298,219,35,740,2,63,85,36,8,194,934,AP
ANDHRA PRADESH,2003,Total Self-employed,26,849,1478,942,330,3625,47,234,298,183,46,808,4433,AP
ARUNACHAL PRADESH,2003,Others (Please Specify),0,0,0,0,0,0,0,0,0,0,0,0,0,AR
ARUNACHAL PRADESH,2003,House Wife,0,0,0,0,0,0,0,8,8,2,0,18,18,AR
ARUNACHAL PRADESH,2003,Service (Government),0,1,7,4,0,12,0,0,2,0,0,2,14,AR
ARUNACHAL PRADESH,2003,Service (Private),0,2,1,0,0,3,0,0,0,0,0,0,3,AR
ARUNACHAL PRADESH,2003,Public Sector Undertaking,0,1,0,0,0,1,0,0,0,0,0,0,1,AR
ARUNACHAL PRADESH,2003,Student,1,0,0,0,0,1,1,3,0,0,0,4,5,AR
ARUNACHAL PRADESH,2003,Unemployed,1,2,0,0,0,3,0,0,0,0,0,0,3,AR
ARUNACHAL PRADESH,2003,Self-employed (Business activity),0,5,12,7,0,24,0,2,0,0,0,2,26,AR
ARUNACHAL PRADESH,2003,Professional Activity,0,0,0,0,0,0,0,0,0,0,0,0,0,AR
ARUNACHAL PRADESH,2003,Farming/Agriculture Activity,1,0,6,1,2,10,0,1,0,0,0,1,11,AR
ARUNACHAL PRADESH,2003,Retired Person,0,0,0,0,0,0,0,0,0,0,0,0,0,AR
ARUNACHAL PRADESH,2003,Total,3,11,26,12,2,54,1,14,10,2,0,27,81,AR
ARUNACHAL PRADESH,2003,Total Salaried,0,4,8,4,0,16,0,0,2,0,0,2,18,AR
ARUNACHAL PRADESH,2003,Total Self-employed,1,5,18,8,2,34,0,3,0,0,0,3,37,AR
ASSAM,2003,Others (Please Specify),33,349,240,138,34,794,27,156,62,29,20,294,1088,AS
ASSAM,2003,House Wife,0,0,0,0,0,0,2,183,126,57,13,381,381,AS
ASSAM,2003,Service (Government),0,2,9,4,0,15,0,0,0,0,0,0,15,AS
ASSAM,2003,Service (Private),0,27,26,33,2,88,0,5,1,2,0,8,96,AS
ASSAM,2003,Public Sector Undertaking,0,35,22,15,1,73,0,16,5,1,0,22,95,AS
ASSAM,2003,Student,24,101,4,0,0,129,19,72,0,0,0,91,220,AS
ASSAM,2003,Unemployed,0,40,111,52,2,205,0,28,28,10,1,67,272,AS
ASSAM,2003,Self-employed (Business activity),0,56,72,51,2,181,0,22,2,2,0,26,207,AS
ASSAM,2003,Professional Activity,2,8,17,3,4,34,0,0,0,0,0,0,34,AS
ASSAM,2003,Farming/Agriculture Activity,2,53,56,27,18,156,0,30,1,0,0,31,187,AS
ASSAM,2003,Retired Person,0,0,0,0,1,1,0,0,0,0,0,0,1,AS
ASSAM,2003,Total,61,671,557,323,64,1676,48,512,225,101,34,920,2596,AS
ASSAM,2003,Total Salaried,0,64,57,52,3,176,0,21,6,3,0,30,206,AS
ASSAM,2003,Total Self-employed,24,387,327,187,41,966,15,150,45,17,13,240,1206,AS
BIHAR,2003,Others (Please Specify),16,53,40,19,4,132,5,31,14,8,4,62,194,BR
BIHAR,2003,House Wife,0,0,0,0,0,0,0,75,61,2,0,138,138,BR
BIHAR,2003,Service (Government),0,0,2,1,0,3,0,1,1,0,0,2,5,BR
BIHAR,2003,Service (Private),0,10,9,2,0,21,0,3,3,0,0,6,27,BR
BIHAR,2003,Public Sector Undertaking,0,0,2,1,0,3,0,0,0,0,0,0,3,BR
BIHAR,2003,Student,15,26,0,0,0,41,9,9,0,0,0,18,59,BR
BIHAR,2003,Unemployed,12,20,27,3,0,62,1,5,5,2,0,13,75,BR
BIHAR,2003,Self-employed (Business activity),0,7,2,9,1,19,0,2,0,0,0,2,21,BR
BIHAR,2003,Professional Activity,1,8,7,3,0,19,0,1,5,0,0,6,25,BR
BIHAR,2003,Farming/Agriculture Activity,5,11,15,12,2,45,0,0,1,0,0,1,46,BR
BIHAR,2003,Retired Person,0,0,0,1,5,6,0,0,0,0,0,0,6,BR
BIHAR,2003,Total,49,135,104,51,12,351,15,127,90,12,4,248,599,BR
BIHAR,2003,Total Salaried,0,10,13,4,0,27,0,4,4,0,0,8,35,BR
BIHAR,2003,Total Self-employed,15,47,41,25,3,131,1,13,13,4,0,31,162,BR
CHANDIGARH,2003,Others (Please Specify),0,4,6,2,1,13,0,1,0,0,0,1,14,CH
CHANDIGARH,2003,House Wife,0,0,0,0,0,0,0,11,7,2,2,22,22,CH
CHANDIGARH,2003,Service (Government),0,2,6,1,0,9,0,0,0,0,0,0,9,CH
CHANDIGARH,2003,Service (Private),0,9,11,3,1,24,0,1,0,0,0,1,25,CH
CHANDIGARH,2003,Public Sector Undertaking,0,0,0,0,0,0,0,0,0,0,0,0,0,CH
CHANDIGARH,2003,Student,0,4,0,0,0,4,1,7,0,0,0,8,12,CH
CHANDIGARH,2003,Unemployed,0,9,3,0,0,12,0,2,1,0,0,3,15,CH
CHANDIGARH,2003,Self-employed (Business activity),0,0,0,0,0,0,0,0,0,0,0,0,0,CH
CHANDIGARH,2003,Professional Activity,0,1,1,0,0,2,0,0,0,0,0,0,2,CH
CHANDIGARH,2003,Farming/Agriculture Activity,0,1,0,1,0,2,0,0,0,0,0,0,2,CH
CHANDIGARH,2003,Retired Person,0,0,0,1,1,2,0,0,0,0,0,0,2,CH
CHANDIGARH,2003,Total,0,30,27,8,3,68,1,22,8,2,2,35,103,CH
CHANDIGARH,2003,Total Salaried,0,11,17,4,1,33,0,1,0,0,0,1,34,CH
CHANDIGARH,2003,Total Self-employed,0,2,1,1,0,4,0,0,0,0,0,0,4,CH
CHHATTISGARH,2003,Others (Please Specify),53,344,362,240,111,1110,55,172,102,54,28,411,1521,CG
CHHATTISGARH,2003,House Wife,0,0,0,0,0,0,3,248,187,80,33,551,551,CG
CHHATTISGARH,2003,Service (Government),0,10,27,17,0,54,0,1,2,0,0,3,57,CG
CHHATTISGARH,2003,Service (Private),0,36,39,27,3,105,0,7,5,3,0,15,120,CG
CHHATTISGARH,2003,Public Sector Undertaking,0,6,14,6,0,26,0,0,0,0,0,0,26,CG
CHHATTISGARH,2003,Student,31,88,6,0,0,125,19,61,0,0,0,80,205,CG
CHHATTISGARH,2003,Unemployed,7,85,56,12,0,160,1,12,7,4,0,24,184,CG
CHHATTISGARH,2003,Self-employed (Business activity),0,15,21,12,4,52,0,4,1,0,0,5,57,CG
CHHATTISGARH,2003,Professional Activity,1,32,43,19,2,97,0,13,14,3,1,31,128,CG
CHHATTISGARH,2003,Farming/Agriculture Activity,11,230,309,220,89,859,28,104,55,17,3,207,1066,CG
CHHATTISGARH,2003,Retired Person,0,0,1,1,2,4,0,0,0,0,0,0,4,CG
CHHATTISGARH,2003,Total,103,846,878,554,211,2592,106,622,373,161,65,1327,3919,CG
CHHATTISGARH,2003,Total Salaried,0,52,80,50,3,185,0,8,7,3,0,18,203,CG
CHHATTISGARH,2003,Total Self-employed,41,420,518,374,141,1494,41,178,105,44,14,382,1876,CG
D & N HAVELI,2003,Others (Please Specify),1,0,0,0,0,1,0,0,0,0,0,0,1,DN
D & N HAVELI,2003,House Wife,0,0,0,0,0,0,0,5,7,9,0,21,21,DN
D & N HAVELI,2003,Service (Government),0,0,1,0,0,1,0,0,0,0,0,0,1,DN
D & N HAVELI,2003,Service (Private),0,0,4,0,0,4,0,0,0,0,0,0,4,DN
D & N HAVELI,2003,Public Sector Undertaking,0,0,0,0,0,0,0,0,0,0,0,0,0,DN
D & N HAVELI,2003,Student,1,0,0,0,0,1,0,1,0,0,0,1,2,DN
D & N HAVELI,2003,Unemployed,0,0,0,0,0,0,0,0,0,0,0,0,0,DN
D & N HAVELI,2003,Self-employed (Business activity),0,0,0,0,0,0,0,0,0,0,0,0,0,DN
D & N HAVELI,2003,Professional Activity,0,0,0,0,0,0,0,0,0,0,0,0,0,DN
D & N HAVELI,2003,Farming/Agriculture Activity,0,8,3,7,5,23,0,0,0,0,0,0,23,DN
D & N HAVELI,2003,Retired Person,0,0,0,0,0,0,0,0,0,0,0,0,0,DN
D & N HAVELI,2003,Total,2,8,8,7,5,30,0,6,7,9,0,22,52,DN
D & N HAVELI,2003,Total Salaried,0,0,5,0,0,5,0,0,0,0,0,0,5,DN
D & N HAVELI,2003,Total Self-employed,0,8,3,7,5,23,0,0,0,0,0,0,23,DN
DAMAN & DIU,2003,Others (Please Specify),1,4,2,2,0,9,0,1,0,0,0,1,10,DD
DAMAN & DIU,2003,House Wife,0,0,0,0,0,0,0,2,2,1,0,5,5,DD
DAMAN & DIU,2003,Service (Government),0,0,0,0,0,0,0,0,0,0,0,0,0,DD
DAMAN & DIU,2003,Service (Private),0,1,3,0,0,4,0,0,0,0,0,0,4,DD
DAMAN & DIU,2003,Public Sector Undertaking,0,0,0,0,0,0,0,0,0,0,0,0,0,DD
DAMAN & DIU,2003,Student,0,0,0,0,0,0,0,0,0,0,0,0,0,DD
DAMAN & DIU,2003,Unemployed,0,1,2,0,0,3,0,0,0,0,0,0,3,DD
DAMAN & DIU,2003,Self-employed (Business activity),0,1,0,0,0,1,0,0,0,0,0,0,1,DD
DAMAN & DIU,2003,Professional Activity,0,0,1,0,0,1,0,0,0,0,0,0,1,DD
DAMAN & DIU,2003,Farming/Agriculture Activity,0,0,0,0,0,0,0,0,0,0,0,0,0,DD
DAMAN & DIU,2003,Retired Person,0,0,0,0,0,0,0,0,0,0,0,0,0,DD
DAMAN & DIU,2003,Total,1,7,8,2,0,18,0,3,2,1,0,6,24,DD
DAMAN & DIU,2003,Total Salaried,0,1,3,0,0,4,0,0,0,0,0,0,4,DD
DAMAN & DIU,2003,Total Self-employed,0,2,2,1,0,5,0,0,0,0,0,0,5,DD
DELHI (UT),2003,Others (Please Specify),8,98,100,45,9,260,5,29,13,2,2,51,311,DL
DELHI (UT),2003,House Wife,0,0,0,0,0,0,0,115,77,26,3,221,221,DL
DELHI (UT),2003,Service (Government),0,7,8,3,0,18,0,8,2,3,0,13,31,DL
DELHI (UT),2003,Service (Private),0,46,46,14,2,108,0,13,7,0,0,20,128,DL
DELHI (UT),2003,Public Sector Undertaking,0,2,6,2,0,10,0,1,0,0,0,1,11,DL
DELHI (UT),2003,Student,9,43,0,0,0,52,12,50,3,0,0,65,117,DL
DELHI (UT),2003,Unemployed,1,119,99,19,15,253,2,19,10,10,0,41,294,DL
DELHI (UT),2003,Self-employed (Business activity),0,5,15,4,1,25,0,0,0,0,0,0,25,DL
DELHI (UT),2003,Professional Activity,0,4,2,1,0,7,0,0,0,0,0,0,7,DL
DELHI (UT),2003,Farming/Agriculture Activity,0,4,2,2,0,8,0,0,0,0,0,0,8,DL
DELHI (UT),2003,Retired Person,0,0,0,0,0,0,0,0,0,0,0,0,0,DL
DELHI (UT),2003,Total,18,328,278,90,27,741,19,235,112,41,5,412,1153,DL
DELHI (UT),2003,Total Salaried,0,55,60,19,2,136,0,22,9,3,0,34,170,DL
DELHI (UT),2003,Total Self-employed,2,53,75,35,5,170,1,19,7,0,0,27,197,DL
GOA,2003,Others (Please Specify),0,10,19,12,8,49,1,3,0,0,1,5,54,GA
GOA,2003,House Wife,0,0,0,0,0,0,0,27,12,8,2,49,49,GA
GOA,2003,Service (Government),0,0,6,1,0,7,0,0,1,0,0,1,8,GA
GOA,2003,Service (Private),0,15,32,15,0,62,0,7,2,1,0,10,72,GA
GOA,2003,Public Sector Undertaking,0,0,1,0,0,1,0,0,0,0,0,0,1,GA
GOA,2003,Student,0,11,1,0,0,12,3,4,0,0,0,7,19,GA
GOA,2003,Unemployed,0,17,26,2,2,47,0,10,1,0,0,11,58,GA
GOA,2003,Self-employed (Business activity),0,6,7,3,0,16,0,0,1,1,0,2,18,GA
GOA,2003,Professional Activity,0,1,1,0,0,2,0,0,1,0,0,1,3,GA
GOA,2003,Farming/Agriculture Activity,0,1,3,9,4,17,0,0,0,1,0,1,18,GA
GOA,2003,Retired Person,0,0,0,0,0,0,0,0,0,0,0,0,0,GA
GOA,2003,Total,0,61,96,42,14,213,4,51,18,11,3,87,300,GA
GOA,2003,Total Salaried,0,15,39,16,0,70,0,7,3,1,0,11,81,GA
GOA,2003,Total Self-employed,0,9,19,19,5,52,0,0,2,2,1,5,57,GA
GUJARAT,2003,Others (Please Specify),10,173,238,108,36,565,18,61,36,20,18,153,718,GJ
GUJARAT,2003,House Wife,0,0,0,0,0,0,1,608,466,202,97,1374,1374,GJ
GUJARAT,2003,Service (Government),0,21,33,15,2,71,0,1,4,0,0,5,76,GJ
GUJARAT,2003,Service (Private),0,120,144,56,6,326,0,34,18,3,0,55,381,GJ
GUJARAT,2003,Public Sector Undertaking,0,8,18,11,0,37,0,7,3,0,0,10,47,GJ
GUJARAT,2003,Student,12,77,2,0,0,91,21,73,1,1,0,96,187,GJ
GUJARAT,2003,Unemployed,0,176,153,64,12,405,3,30,16,6,1,56,461,GJ
GUJARAT,2003,Self-employed (Business activity),0,59,98,50,18,225,0,3,0,0,0,3,228,GJ
GUJARAT,2003,Professional Activity,0,143,135,81,17,376,0,8,1,0,5,14,390,GJ
GUJARAT,2003,Farming/Agriculture Activity,0,149,169,121,30,469,0,46,33,24,9,112,581,GJ
GUJARAT,2003,Retired Person,0,5,6,17,57,85,0,2,3,4,29,38,123,GJ
GUJARAT,2003,Total,22,931,996,523,178,2650,43,873,581,260,159,1916,4566,GJ
GUJARAT,2003,Total Salaried,0,149,195,82,8,434,0,42,25,3,0,70,504,GJ
GUJARAT,2003,Total Self-employed,2,464,574,324,75,1439,11,94,50,31,21,207,1646,GJ
HARYANA,2003,Others (Please Specify),20,236,240,104,48,648,14,49,46,22,9,140,788,HR
HARYANA,2003,House Wife,0,0,0,0,0,0,0,173,107,29,12,321,321,HR
HARYANA,2003,Service (Government),0,20,28,20,0,68,0,5,4,1,0,10,78,HR
HARYANA,2003,Service (Private),6,68,90,25,1,190,0,26,8,2,0,36,226,HR
HARYANA,2003,Public Sector Undertaking,0,17,33,4,0,54,0,10,6,1,0,17,71,HR
HARYANA,2003,Student,5,69,12,0,0,86,10,28,1,0,0,39,125,HR
HARYANA,2003,Unemployed,2,89,65,25,3,184,1,17,7,3,0,28,212,HR
HARYANA,2003,Self-employed (Business activity),0,7,55,50,23,135,0,1,0,0,0,1,136,HR
HARYANA,2003,Professional Activity,0,11,13,9,0,33,0,0,0,0,0,0,33,HR
HARYANA,2003,Farming/Agriculture Activity,1,59,66,51,15,192,0,5,6,4,0,15,207,HR
HARYANA,2003,Retired Person,0,0,0,10,13,23,0,0,0,4,3,7,30,HR
HARYANA,2003,Total,34,576,602,298,103,1613,25,314,185,66,24,614,2227,HR
HARYANA,2003,Total Salaried,6,105,151,49,1,312,0,41,18,4,0,63,375,HR
HARYANA,2003,Total Self-employed,5,197,159,136,50,547,6,30,31,17,5,89,636,HR
HIMACHAL PRADESH,2003,Others (Please Specify),0,30,26,33,8,97,1,16,16,10,2,45,142,HP
HIMACHAL PRADESH,2003,House Wife,0,0,0,0,0,0,0,37,25,10,0,72,72,HP
HIMACHAL PRADESH,2003,Service (Government),0,1,8,5,0,14,0,0,1,1,0,2,16,HP
HIMACHAL PRADESH,2003,Service (Private),0,8,12,9,1,30,0,1,1,0,0,2,32,HP
HIMACHAL PRADESH,2003,Public Sector Undertaking,0,0,2,0,0,2,0,0,0,0,0,0,2,HP
HIMACHAL PRADESH,2003,Student,2,9,0,0,0,11,4,15,0,0,0,19,30,HP
HIMACHAL PRADESH,2003,Unemployed,0,24,15,0,2,41,0,1,0,0,0,1,42,HP
HIMACHAL PRADESH,2003,Self-employed (Business activity),0,0,5,6,2,13,0,0,0,0,0,0,13,HP
HIMACHAL PRADESH,2003,Professional Activity,0,1,0,0,1,2,0,0,0,0,0,0,2,HP
HIMACHAL PRADESH,2003,Farming/Agriculture Activity,0,5,13,10,1,29,0,2,3,0,0,5,34,HP
HIMACHAL PRADESH,2003,Retired Person,0,0,0,0,1,1,0,0,0,0,0,0,1,HP
HIMACHAL PRADESH,2003,Total,2,78,81,63,16,240,5,72,46,21,2,146,386,HP
HIMACHAL PRADESH,2003,Total Salaried,0,9,22,14,1,46,0,1,2,1,0,4,50,HP
HIMACHAL PRADESH,2003,Total Self-employed,0,13,32,33,8,86,1,5,4,1,0,11,97,HP
JAMMU & KASHMIR,2003,Others (Please Specify),1,19,15,8,4,47,3,15,7,3,1,29,76,JK
JAMMU & KASHMIR,2003,House Wife,0,0,0,0,0,0,1,26,12,0,2,41,41,JK
JAMMU & KASHMIR,2003,Service (Government),0,2,3,0,0,5,0,0,0,0,0,0,5,JK
JAMMU & KASHMIR,2003,Service (Private),0,0,0,0,0,0,0,0,0,0,0,0,0,JK
JAMMU & KASHMIR,2003,Public Sector Undertaking,0,0,0,0,0,0,0,0,0,0,0,0,0,JK
JAMMU & KASHMIR,2003,Student,0,2,0,0,0,2,0,2,0,0,0,2,4,JK
JAMMU & KASHMIR,2003,Unemployed,0,3,1,0,0,4,0,0,0,0,0,0,4,JK
JAMMU & KASHMIR,2003,Self-employed (Business activity),0,0,0,0,0,0,0,0,0,0,0,0,0,JK
JAMMU & KASHMIR,2003,Professional Activity,0,0,0,0,0,0,0,0,0,0,0,0,0,JK
JAMMU & KASHMIR,2003,Farming/Agriculture Activity,0,4,0,1,0,5,1,0,2,0,0,3,8,JK
JAMMU & KASHMIR,2003,Retired Person,0,0,0,0,0,0,0,0,0,0,0,0,0,JK
JAMMU & KASHMIR,2003,Total,1,30,19,9,4,63,5,43,21,3,3,75,138,JK
JAMMU & KASHMIR,2003,Total Salaried,0,2,3,0,0,5,0,0,0,0,0,0,5,JK
JAMMU & KASHMIR,2003,Total Self-employed,0,6,2,2,0,10,1,2,2,0,0,5,15,JK
JHARKHAND,2003,Others (Please Specify),6,23,21,17,9,76,4,15,8,17,0,44,120,JH
JHARKHAND,2003,House Wife,0,0,0,0,0,0,0,28,25,10,0,63,63,JH
JHARKHAND,2003,Service (Government),0,0,0,0,0,0,0,0,0,0,0,0,0,JH
JHARKHAND,2003,Service (Private),0,0,4,1,0,5,0,0,3,0,0,3,8,JH
JHARKHAND,2003,Public Sector Undertaking,0,0,2,1,0,3,0,0,2,1,0,3,6,JH
JHARKHAND,2003,Student,3,4,0,0,0,7,0,3,0,0,0,3,10,JH
JHARKHAND,2003,Unemployed,0,8,8,11,0,27,0,1,1,0,0,2,29,JH
JHARKHAND,2003,Self-employed (Business activity),0,0,2,1,0,3,0,0,1,0,0,1,4,JH
JHARKHAND,2003,Professional Activity,0,4,1,2,2,9,0,0,0,0,0,0,9,JH
JHARKHAND,2003,Farming/Agriculture Activity,0,4,14,3,0,21,0,0,0,0,0,0,21,JH
JHARKHAND,2003,Retired Person,0,2,0,0,0,2,0,0,0,0,0,0,2,JH
JHARKHAND,2003,Total,9,45,52,36,11,153,4,47,40,28,0,119,272,JH
JHARKHAND,2003,Total Salaried,0,0,6,2,0,8,0,0,5,1,0,6,14,JH
JHARKHAND,2003,Total Self-employed,0,26,27,12,2,67,0,10,1,2,0,13,80,JH
KARNATAKA,2003,Others (Please Specify),53,982,1159,743,411,3348,54,510,410,160,77,1211,4559,KA
KARNATAKA,2003,House Wife,0,0,0,0,0,0,6,703,658,309,188,1864,1864,KA
KARNATAKA,2003,Service (Government),0,40,75,81,2,198,0,14,11,0,0,25,223,KA
KARNATAKA,2003,Service (Private),5,194,266,161,62,688,0,71,51,34,8,164,852,KA
KARNATAKA,2003,Public Sector Undertaking,0,57,91,56,8,212,2,17,6,8,1,34,246,KA
KARNATAKA,2003,Student,54,154,16,2,1,227,62,127,4,2,0,195,422,KA
KARNATAKA,2003,Unemployed,12,235,207,132,64,650,3,63,26,8,7,107,757,KA
KARNATAKA,2003,Self-employed (Business activity),10,127,212,150,45,544,6,5,4,3,2,20,564,KA
KARNATAKA,2003,Professional Activity,0,44,60,26,6,136,0,2,4,2,0,8,144,KA
KARNATAKA,2003,Farming/Agriculture Activity,8,593,809,642,274,2326,21,119,107,85,20,352,2678,KA
KARNATAKA,2003,Retired Person,0,0,0,9,37,46,0,0,0,0,6,6,52,KA
KARNATAKA,2003,Total,142,2426,2895,2002,910,8375,154,1631,1281,611,309,3986,12361,KA
KARNATAKA,2003,Total Salaried,5,291,432,298,72,1098,2,102,68,42,9,223,1321,KA
KARNATAKA,2003,Total Self-employed,38,1389,1856,1293,541,5117,55,384,323,180,68,1010,6127,KA
KERALA,2003,Others (Please Specify),7,558,1022,1009,688,3284,15,197,98,109,128,547,3831,KL
KERALA,2003,House Wife,0,0,0,0,0,0,0,294,467,373,297,1431,1431,KL
KERALA,2003,Service (Government),0,4,35,47,0,86,0,7,5,7,0,19,105,KL
KERALA,2003,Service (Private),0,54,142,105,24,325,0,16,17,5,3,41,366,KL
KERALA,2003,Public Sector Undertaking,0,8,22,32,1,63,0,8,0,4,0,12,75,KL
KERALA,2003,Student,43,109,8,0,0,160,33,109,12,0,0,154,314,KL
KERALA,2003,Unemployed,0,249,195,207,232,883,1,118,28,24,45,216,1099,KL
KERALA,2003,Self-employed (Business activity),0,51,133,141,64,389,0,4,3,0,0,7,396,KL
KERALA,2003,Professional Activity,0,26,65,46,12,149,0,3,2,1,0,6,155,KL
KERALA,2003,Farming/Agriculture Activity,0,141,407,600,372,1520,0,18,15,17,13,63,1583,KL
KERALA,2003,Retired Person,0,0,3,29,44,76,0,0,0,4,3,7,83,KL
KERALA,2003,Total,50,1200,2032,2216,1437,6935,49,774,647,544,489,2503,9438,KL
KERALA,2003,Total Salaried,0,66,199,184,25,474,0,31,22,16,3,72,546,KL
KERALA,2003,Total Self-employed,3,608,1328,1508,917,4364,4,181,98,119,91,493,4857,KL
LAKSHADWEEP,2003,Others (Please Specify),0,0,0,0,1,1,0,0,0,0,0,0,1,LD
LAKSHADWEEP,2003,House Wife,0,0,0,0,0,0,0,1,0,0,0,1,1,LD
LAKSHADWEEP,2003,Service (Government),0,0,0,0,0,0,0,0,0,0,0,0,0,LD
LAKSHADWEEP,2003,Service (Private),0,0,0,0,0,0,0,0,0,0,0,0,0,LD
LAKSHADWEEP,2003,Public Sector Undertaking,0,0,0,0,0,0,0,0,0,0,0,0,0,LD
LAKSHADWEEP,2003,Student,0,0,0,0,0,0,0,0,0,0,0,0,0,LD
LAKSHADWEEP,2003,Unemployed,0,0,0,0,0,0,0,0,0,0,0,0,0,LD
LAKSHADWEEP,2003,Self-employed (Business activity),0,0,0,0,0,0,0,0,0,0,0,0,0,LD
LAKSHADWEEP,2003,Professional Activity,0,0,0,0,0,0,0,0,0,0,0,0,0,LD
LAKSHADWEEP,2003,Farming/Agriculture Activity,0,0,0,0,0,0,0,0,0,0,0,0,0,LD
LAKSHADWEEP,2003,Retired Person,0,0,0,0,0,0,0,0,0,0,0,0,0,LD
LAKSHADWEEP,2003,Total,0,0,0,0,1,1,0,1,0,0,0,1,2,LD
LAKSHADWEEP,2003,Total Salaried,0,0,0,0,0,0,0,0,0,0,0,0,0,LD
LAKSHADWEEP,2003,Total Self-employed,0,0,0,0,0,0,0,0,0,0,0,0,0,LD
MADHYA PRADESH,2003,Others (Please Specify),44,288,294,196,91,913,40,286,94,30,22,472,1385,MP
MADHYA PRADESH,2003,House Wife,0,0,0,0,0,0,1,1185,576,188,79,2029,2029,MP
MADHYA PRADESH,2003,Service (Government),0,88,88,27,1,204,1,34,22,5,0,62,266,MP
MADHYA PRADESH,2003,Service (Private),0,148,125,43,9,325,0,51,21,2,0,74,399,MP
MADHYA PRADESH,2003,Public Sector Undertaking,0,60,57,15,3,135,1,15,2,5,0,23,158,MP
MADHYA PRADESH,2003,Student,46,136,2,0,0,184,40,98,0,0,0,138,322,MP
MADHYA PRADESH,2003,Unemployed,0,119,68,19,13,219,0,5,7,0,0,12,231,MP
MADHYA PRADESH,2003,Self-employed (Business activity),0,86,81,43,33,243,0,17,15,8,10,50,293,MP
MADHYA PRADESH,2003,Professional Activity,0,52,68,46,23,189,0,5,8,4,5,22,211,MP
MADHYA PRADESH,2003,Farming/Agriculture Activity,4,402,431,177,89,1103,6,183,115,29,9,342,1445,MP
MADHYA PRADESH,2003,Retired Person,0,0,0,0,23,23,0,0,0,0,0,0,23,MP
MADHYA PRADESH,2003,Total,94,1379,1214,566,285,3538,89,1879,860,271,125,3224,6762,MP
MADHYA PRADESH,2003,Total Salaried,0,296,270,85,13,664,2,100,45,12,0,159,823,MP
MADHYA PRADESH,2003,Total Self-employed,31,715,781,374,198,2099,32,473,220,68,43,836,2935,MP
MAHARASHTRA,2003,Others (Please Specify),9,633,870,562,240,2314,6,121,64,41,19,251,2565,MH
MAHARASHTRA,2003,House Wife,0,0,0,0,0,0,0,1701,1206,410,205,3522,3522,MH
MAHARASHTRA,2003,Service (Government),0,43,126,77,0,246,0,14,13,3,0,30,276,MH
MAHARASHTRA,2003,Service (Private),0,419,683,297,33,1432,0,86,72,13,0,171,1603,MH
MAHARASHTRA,2003,Public Sector Undertaking,0,24,58,36,0,118,0,9,5,3,0,17,135,MH
MAHARASHTRA,2003,Student,81,408,10,0,0,499,81,290,4,0,0,375,874,MH
MAHARASHTRA,2003,Unemployed,1,414,350,105,17,887,1,42,25,13,0,81,968,MH
MAHARASHTRA,2003,Self-employed (Business activity),0,152,223,122,22,519,0,11,11,4,0,26,545,MH
MAHARASHTRA,2003,Professional Activity,0,74,116,62,18,270,0,10,4,1,1,16,286,MH
MAHARASHTRA,2003,Farming/Agriculture Activity,8,899,1310,812,352,3381,4,202,148,73,28,455,3836,MH
MAHARASHTRA,2003,Retired Person,0,0,1,33,110,144,0,0,0,0,6,6,150,MH
MAHARASHTRA,2003,Total,99,3066,3747,2106,792,9810,92,2486,1552,561,259,4950,14760,MH
MAHARASHTRA,2003,Total Salaried,0,486,867,410,33,1796,0,109,90,19,0,218,2014,MH
MAHARASHTRA,2003,Total Self-employed,17,1717,2480,1542,620,6376,10,340,225,115,46,736,7112,MH
MANIPUR,2003,Others (Please Specify),0,0,0,0,0,0,0,0,0,0,0,0,0,MN
MANIPUR,2003,House Wife,0,0,0,0,0,0,0,1,0,0,1,2,2,MN
MANIPUR,2003,Service (Government),0,0,2,2,0,4,0,0,0,0,0,0,4,MN
MANIPUR,2003,Service (Private),0,0,0,0,0,0,0,0,0,0,0,0,0,MN
MANIPUR,2003,Public Sector Undertaking,0,0,0,0,0,0,0,0,0,0,0,0,0,MN
MANIPUR,2003,Student,0,9,0,0,0,9,0,3,0,0,0,3,12,MN
MANIPUR,2003,Unemployed,0,0,0,0,0,0,0,0,0,0,0,0,0,MN
MANIPUR,2003,Self-employed (Business activity),0,0,4,0,0,4,0,0,0,0,0,0,4,MN
MANIPUR,2003,Professional Activity,0,0,0,0,0,0,0,0,0,0,0,0,0,MN
MANIPUR,2003,Farming/Agriculture Activity,0,0,0,1,3,4,0,0,0,0,0,0,4,MN
MANIPUR,2003,Retired Person,0,0,0,0,0,0,0,0,0,0,0,0,0,MN
MANIPUR,2003,Total,0,9,6,3,3,21,0,4,0,0,1,5,26,MN
MANIPUR,2003,Total Salaried,0,0,2,2,0,4,0,0,0,0,0,0,4,MN
MANIPUR,2003,Total Self-employed,0,0,4,1,3,8,0,0,0,0,0,0,8,MN
MEGHALAYA,2003,Others (Please Specify),1,2,5,2,0,10,0,4,2,0,0,6,16,ML
MEGHALAYA,2003,House Wife,0,0,0,0,0,0,0,0,0,0,1,1,1,ML
MEGHALAYA,2003,Service (Government),0,1,2,1,0,4,0,0,0,0,0,0,4,ML
MEGHALAYA,2003,Service (Private),0,2,3,1,0,6,0,0,0,0,0,0,6,ML
MEGHALAYA,2003,Public Sector Undertaking,0,0,0,0,0,0,0,0,0,0,0,0,0,ML
MEGHALAYA,2003,Student,2,0,0,0,0,2,1,0,0,0,0,1,3,ML
MEGHALAYA,2003,Unemployed,0,2,4,0,0,6,0,0,0,0,0,0,6,ML
MEGHALAYA,2003,Self-employed (Business activity),0,0,0,0,0,0,0,1,0,0,0,1,1,ML
MEGHALAYA,2003,Professional Activity,0,0,0,0,0,0,0,0,0,0,0,0,0,ML
MEGHALAYA,2003,Farming/Agriculture Activity,0,0,0,3,1,4,0,0,0,0,0,0,4,ML
MEGHALAYA,2003,Retired Person,0,0,0,0,0,0,0,0,0,0,0,0,0,ML
MEGHALAYA,2003,Total,3,7,14,7,1,32,1,5,2,0,1,9,41,ML
MEGHALAYA,2003,Total Salaried,0,3,5,2,0,10,0,0,0,0,0,0,10,ML
MEGHALAYA,2003,Total Self-employed,1,2,5,5,1,14,0,5,2,0,0,7,21,ML
MIZORAM,2003,Others (Please Specify),1,7,8,3,0,19,0,3,7,1,0,11,30,MZ
MIZORAM,2003,House Wife,0,0,0,0,0,0,0,0,0,0,0,0,0,MZ
MIZORAM,2003,Service (Government),0,1,2,1,0,4,0,0,0,0,0,0,4,MZ
MIZORAM,2003,Service (Private),0,4,1,0,0,5,0,0,0,0,0,0,5,MZ
MIZORAM,2003,Public Sector Undertaking,0,0,0,0,0,0,0,0,0,0,0,0,0,MZ
MIZORAM,2003,Student,0,1,0,0,0,1,0,0,0,0,0,0,1,MZ
MIZORAM,2003,Unemployed,0,4,5,0,0,9,0,0,0,0,0,0,9,MZ
MIZORAM,2003,Self-employed (Business activity),0,1,0,2,0,3,0,0,0,0,0,0,3,MZ
MIZORAM,2003,Professional Activity,0,0,0,0,0,0,0,0,0,0,0,0,0,MZ
MIZORAM,2003,Farming/Agriculture Activity,0,0,0,0,0,0,0,0,0,0,0,0,0,MZ
MIZORAM,2003,Retired Person,0,0,0,0,0,0,0,0,0,0,0,0,0,MZ
MIZORAM,2003,Total,1,18,16,6,0,41,0,3,7,1,0,11,52,MZ
MIZORAM,2003,Total Salaried,0,5,3,1,0,9,0,0,0,0,0,0,9,MZ
MIZORAM,2003,Total Self-employed,1,6,7,4,0,18,0,2,7,1,0,10,28,MZ
NAGALAND,2003,Others (Please Specify),0,2,2,0,0,4,0,0,0,0,0,0,4,NG
NAGALAND,2003,House Wife,0,0,0,0,0,0,0,4,0,0,0,4,4,NG
NAGALAND,2003,Service (Government),0,0,7,0,0,7,0,0,0,0,0,0,7,NG
NAGALAND,2003,Service (Private),0,0,0,0,0,0,0,0,0,0,0,0,0,NG
NAGALAND,2003,Public Sector Undertaking,0,0,0,0,0,0,0,0,0,0,0,0,0,NG
NAGALAND,2003,Student,0,1,0,0,0,1,0,1,0,0,0,1,2,NG
NAGALAND,2003,Unemployed,0,3,1,0,0,4,0,0,0,0,0,0,4,NG
NAGALAND,2003,Self-employed (Business activity),0,0,1,0,0,1,0,0,0,0,0,0,1,NG
NAGALAND,2003,Professional Activity,0,0,0,0,0,0,0,0,0,0,0,0,0,NG
NAGALAND,2003,Farming/Agriculture Activity,0,0,0,0,0,0,0,0,0,0,0,0,0,NG
NAGALAND,2003,Retired Person,0,0,0,0,0,0,0,0,0,0,0,0,0,NG
NAGALAND,2003,Total,0,6,11,0,0,17,0,5,0,0,0,5,22,NG
NAGALAND,2003,Total Salaried,0,0,7,0,0,7,0,0,0,0,0,0,7,NG
NAGALAND,2003,Total Self-employed,0,1,1,0,0,2,0,0,0,0,0,0,2,NG
ODISHA,2003,Others (Please Specify),44,295,405,299,104,1147,21,210,127,102,38,498,1645,OD
ODISHA,2003,House Wife,0,0,0,0,0,0,0,306,205,110,26,647,647,OD
ODISHA,2003,Service (Government),1,20,17,24,0,62,0,43,36,12,0,91,153,OD
ODISHA,2003,Service (Private),5,149,102,107,14,377,0,30,30,21,3,84,461,OD
ODISHA,2003,Public Sector Undertaking,0,21,29,56,0,106,0,10,4,0,0,14,120,OD
ODISHA,2003,Student,16,101,17,13,0,147,22,86,3,1,0,112,259,OD
ODISHA,2003,Unemployed,0,145,116,33,3,297,2,75,47,8,0,132,429,OD
ODISHA,2003,Self-employed (Business activity),0,65,69,48,2,184,1,15,8,6,0,30,214,OD
ODISHA,2003,Professional Activity,0,26,17,12,0,55,0,6,9,7,0,22,77,OD
ODISHA,2003,Farming/Agriculture Activity,1,101,136,69,17,324,0,21,10,10,0,41,365,OD
ODISHA,2003,Retired Person,0,3,1,0,37,41,0,0,4,4,1,9,50,OD
ODISHA,2003,Total,67,926,909,661,177,2740,46,802,483,281,68,1680,4420,OD
ODISHA,2003,Total Salaried,6,190,148,187,14,545,0,83,70,33,3,189,734,OD
ODISHA,2003,Total Self-employed,17,396,492,343,89,1337,7,170,103,85,27,392,1729,OD
PUDUCHERRY,2003,Others (Please Specify),0,47,72,41,18,178,0,7,2,4,0,13,191,PY
PUDUCHERRY,2003,House Wife,0,0,0,0,0,0,0,49,28,14,17,108,108,PY
PUDUCHERRY,2003,Service (Government),0,1,3,4,0,8,0,1,1,0,0,2,10,PY
PUDUCHERRY,2003,Service (Private),0,9,5,2,1,17,0,10,0,0,0,10,27,PY
PUDUCHERRY,2003,Public Sector Undertaking,0,1,5,4,1,11,0,0,0,0,0,0,11,PY
PUDUCHERRY,2003,Student,3,12,0,0,0,15,0,15,0,0,0,15,30,PY
PUDUCHERRY,2003,Unemployed,0,18,10,9,8,45,0,40,1,0,1,42,87,PY
PUDUCHERRY,2003,Self-employed (Business activity),0,4,8,4,4,20,0,1,0,0,0,1,21,PY
PUDUCHERRY,2003,Professional Activity,1,21,33,17,1,73,0,1,0,0,0,1,74,PY
PUDUCHERRY,2003,Farming/Agriculture Activity,0,1,10,7,3,21,0,2,0,0,0,2,23,PY
PUDUCHERRY,2003,Retired Person,0,0,0,0,0,0,0,0,0,0,0,0,0,PY
PUDUCHERRY,2003,Total,4,114,146,88,36,388,0,126,32,18,18,194,582,PY
PUDUCHERRY,2003,Total Salaried,0,11,13,10,2,36,0,11,1,0,0,12,48,PY
PUDUCHERRY,2003,Total Self-employed,1,73,123,66,25,288,0,11,2,4,0,17,305,PY
PUNJAB,2003,Others (Please Specify),3,125,97,56,30,311,1,13,12,3,1,30,341,PN
PUNJAB,2003,House Wife,0,0,0,0,0,0,0,33,34,5,2,74,74,PN
PUNJAB,2003,Service (Government),0,3,4,3,0,10,0,0,1,1,0,2,12,PN
PUNJAB,2003,Service (Private),0,16,13,2,3,34,0,2,2,0,1,5,39,PN
PUNJAB,2003,Public Sector Undertaking,0,0,2,0,0,2,0,0,0,0,0,0,2,PN
PUNJAB,2003,Student,0,13,1,0,0,14,3,6,0,0,0,9,23,PN
PUNJAB,2003,Unemployed,0,26,17,11,1,55,1,1,1,0,0,3,58,PN
PUNJAB,2003,Self-employed (Business activity),0,19,13,13,1,46,0,1,0,0,0,1,47,PN
PUNJAB,2003,Professional Activity,0,1,1,0,0,2,0,0,0,0,0,0,2,PN
PUNJAB,2003,Farming/Agriculture Activity,0,11,8,6,0,25,0,0,0,1,0,1,26,PN
PUNJAB,2003,Retired Person,0,0,0,1,6,7,0,0,0,0,0,0,7,PN
PUNJAB,2003,Total,3,214,156,92,41,506,5,56,50,10,4,125,631,PN
PUNJAB,2003,Total Salaried,0,19,19,5,3,46,0,2,3,1,1,7,53,PN
PUNJAB,2003,Total Self-employed,2,70,65,50,5,192,0,3,2,1,0,6,198,PN
RAJASTHAN,2003,Others (Please Specify),42,316,313,176,107,954,21,69,26,16,10,142,1096,RJ
RAJASTHAN,2003,House Wife,0,0,0,0,0,0,2,417,336,137,46,938,938,RJ
RAJASTHAN,2003,Service (Government),0,3,25,14,0,42,0,2,1,0,0,3,45,RJ
RAJASTHAN,2003,Service (Private),0,63,124,61,10,258,0,14,11,2,0,27,285,RJ
RAJASTHAN,2003,Public Sector Undertaking,0,22,35,16,0,73,0,11,6,1,0,18,91,RJ
RAJASTHAN,2003,Student,24,110,4,0,0,138,13,51,3,0,0,67,205,RJ
RAJASTHAN,2003,Unemployed,0,70,66,22,0,158,0,3,0,0,0,3,161,RJ
RAJASTHAN,2003,Self-employed (Business activity),0,33,72,30,5,140,0,0,0,0,0,0,140,RJ
RAJASTHAN,2003,Professional Activity,0,12,22,10,2,46,0,0,0,0,0,0,46,RJ
RAJASTHAN,2003,Farming/Agriculture Activity,0,195,218,111,38,562,0,34,27,12,1,74,636,RJ
RAJASTHAN,2003,Retired Person,0,0,0,10,8,18,0,0,0,0,0,0,18,RJ
RAJASTHAN,2003,Total,66,824,879,450,170,2389,36,601,410,168,57,1272,3661,RJ
RAJASTHAN,2003,Total Salaried,0,88,184,91,10,373,0,27,18,3,0,48,421,RJ
RAJASTHAN,2003,Total Self-employed,11,425,502,274,135,1347,8,75,43,17,4,147,1494,RJ
SIKKIM,2003,Others (Please Specify),0,0,0,4,1,5,0,0,0,0,0,0,5,SK
SIKKIM,2003,House Wife,0,0,0,0,0,0,0,7,5,4,5,21,21,SK
SIKKIM,2003,Service (Government),0,0,3,2,1,6,0,0,3,0,0,3,9,SK
SIKKIM,2003,Service (Private),0,4,2,4,3,13,0,0,0,0,0,0,13,SK
SIKKIM,2003,Public Sector Undertaking,0,0,0,0,0,0,0,0,0,0,0,0,0,SK
SIKKIM,2003,Student,1,7,0,0,1,9,0,1,0,0,0,1,10,SK
SIKKIM,2003,Unemployed,0,6,5,0,1,12,0,1,0,0,0,1,13,SK
SIKKIM,2003,Self-employed (Business activity),0,0,3,0,0,3,0,0,0,0,0,0,3,SK
SIKKIM,2003,Professional Activity,0,0,0,0,0,0,0,0,0,0,0,0,0,SK
SIKKIM,2003,Farming/Agriculture Activity,0,8,3,4,5,20,0,0,0,7,4,11,31,SK
SIKKIM,2003,Retired Person,0,0,0,0,0,0,0,0,0,0,0,0,0,SK
SIKKIM,2003,Total,1,25,16,14,12,68,0,9,8,11,9,37,105,SK
SIKKIM,2003,Total Salaried,0,4,5,6,4,19,0,0,3,0,0,3,22,SK
SIKKIM,2003,Total Self-employed,0,8,6,8,6,28,0,0,0,7,4,11,39,SK
TAMIL NADU,2003,Others (Please Specify),64,457,724,618,269,2132,75,228,296,166,123,888,3020,TN
TAMIL NADU,2003,House Wife,0,0,0,0,0,0,0,779,777,409,103,2068,2068,TN
TAMIL NADU,2003,Service (Government),0,36,74,74,5,189,0,31,22,24,0,77,266,TN
TAMIL NADU,2003,Service (Private),0,208,321,223,42,794,0,179,155,93,10,437,1231,TN
TAMIL NADU,2003,Public Sector Undertaking,0,78,141,78,11,308,0,32,44,24,1,101,409,TN
TAMIL NADU,2003,Student,60,170,17,0,0,247,79,136,4,0,0,219,466,TN
TAMIL NADU,2003,Unemployed,11,490,524,298,145,1468,7,200,147,123,29,506,1974,TN
TAMIL NADU,2003,Self-employed (Business activity),1,155,258,240,46,700,0,38,38,23,7,106,806,TN
TAMIL NADU,2003,Professional Activity,0,127,159,95,36,417,0,20,23,33,3,79,496,TN
TAMIL NADU,2003,Farming/Agriculture Activity,1,244,300,200,87,832,5,101,71,27,16,220,1052,TN
TAMIL NADU,2003,Retired Person,0,0,0,15,52,67,0,0,0,4,13,17,84,TN
TAMIL NADU,2003,Total,137,1965,2518,1841,693,7154,166,1744,1577,926,305,4718,11872,TN
TAMIL NADU,2003,Total Salaried,0,322,536,375,58,1291,0,242,221,141,11,615,1906,TN
TAMIL NADU,2003,Total Self-employed,26,851,1178,950,326,3331,30,269,250,157,76,782,4113,TN
TRIPURA,2003,Others (Please Specify),0,18,10,6,0,34,3,6,5,1,0,15,49,TR
TRIPURA,2003,House Wife,0,0,0,0,0,0,0,52,51,17,0,120,120,TR
TRIPURA,2003,Service (Government),0,12,4,3,0,19,0,3,3,3,0,9,28,TR
TRIPURA,2003,Service (Private),0,14,6,3,0,23,0,2,2,0,0,4,27,TR
TRIPURA,2003,Public Sector Undertaking,0,17,11,7,0,35,0,4,4,2,0,10,45,TR
TRIPURA,2003,Student,7,59,70,21,0,157,2,29,31,11,0,73,230,TR
TRIPURA,2003,Unemployed,0,74,85,49,0,208,3,35,40,24,0,102,310,TR
TRIPURA,2003,Self-employed (Business activity),0,4,2,1,0,7,0,4,3,2,0,9,16,TR
TRIPURA,2003,Professional Activity,0,0,0,1,0,1,0,3,2,1,0,6,7,TR
TRIPURA,2003,Farming/Agriculture Activity,0,0,0,0,0,0,0,2,1,1,0,4,4,TR
TRIPURA,2003,Retired Person,0,0,0,0,4,4,0,0,0,0,4,4,8,TR
TRIPURA,2003,Total,7,198,188,91,4,488,8,140,142,62,4,356,844,TR
TRIPURA,2003,Total Salaried,0,43,21,13,0,77,0,9,9,5,0,23,100,TR
TRIPURA,2003,Total Self-employed,0,15,9,6,0,30,0,13,10,4,0,27,57,TR
UTTAR PRADESH,2003,Others (Please Specify),49,213,107,138,77,584,42,117,37,32,33,261,845,UP
UTTAR PRADESH,2003,House Wife,0,0,0,0,0,0,2,548,310,159,54,1073,1073,UP
UTTAR PRADESH,2003,Service (Government),0,19,15,9,0,43,0,6,10,1,0,17,60,UP
UTTAR PRADESH,2003,Service (Private),4,23,93,46,7,173,0,36,26,11,2,75,248,UP
UTTAR PRADESH,2003,Public Sector Undertaking,1,9,28,12,7,57,0,4,1,0,0,5,62,UP
UTTAR PRADESH,2003,Student,24,93,0,1,0,118,27,64,7,0,0,98,216,UP
UTTAR PRADESH,2003,Unemployed,3,195,141,42,11,392,3,35,16,7,1,62,454,UP
UTTAR PRADESH,2003,Self-employed (Business activity),0,48,57,31,8,144,0,5,4,8,2,19,163,UP
UTTAR PRADESH,2003,Professional Activity,1,34,44,18,9,106,0,7,3,1,0,11,117,UP
UTTAR PRADESH,2003,Farming/Agriculture Activity,0,129,132,56,24,341,0,23,16,3,4,46,387,UP
UTTAR PRADESH,2003,Retired Person,0,0,5,10,14,29,0,7,0,1,1,9,38,UP
UTTAR PRADESH,2003,Total,82,763,622,363,157,1987,74,852,430,223,97,1676,3663,UP
UTTAR PRADESH,2003,Total Salaried,5,51,136,67,14,273,0,46,37,12,2,97,370,UP
UTTAR PRADESH,2003,Total Self-employed,25,305,329,185,85,929,17,79,51,43,32,222,1151,UP
UTTARAKHAND,2003,Others (Please Specify),0,25,20,13,4,62,2,7,2,3,2,16,78,UK
UTTARAKHAND,2003,House Wife,0,0,0,0,0,0,0,49,21,10,1,81,81,UK
UTTARAKHAND,2003,Service (Government),0,4,6,4,0,14,0,1,0,0,0,1,15,UK
UTTARAKHAND,2003,Service (Private),0,19,29,12,0,60,0,12,3,0,0,15,75,UK
UTTARAKHAND,2003,Public Sector Undertaking,0,1,1,0,0,2,0,0,4,1,0,5,7,UK
UTTARAKHAND,2003,Student,0,9,0,0,0,9,1,7,0,0,0,8,17,UK
UTTARAKHAND,2003,Unemployed,0,30,15,10,0,55,0,0,0,0,0,0,55,UK
UTTARAKHAND,2003,Self-employed (Business activity),0,4,4,3,0,11,0,0,0,0,0,0,11,UK
UTTARAKHAND,2003,Professional Activity,0,5,2,2,0,9,0,0,1,0,0,1,10,UK
UTTARAKHAND,2003,Farming/Agriculture Activity,0,14,14,10,1,39,0,1,1,0,0,2,41,UK
UTTARAKHAND,2003,Retired Person,0,0,0,1,0,1,0,0,0,0,0,0,1,UK
UTTARAKHAND,2003,Total,0,111,91,55,5,262,3,77,32,14,3,129,391,UK
UTTARAKHAND,2003,Total Salaried,0,24,36,16,0,76,0,13,7,1,0,21,97,UK
UTTARAKHAND,2003,Total Self-employed,0,39,36,27,4,106,0,5,3,3,1,12,118,UK
WEST BENGAL,2003,Others (Please Specify),20,459,718,392,184,1773,37,173,139,130,94,573,2346,WB
WEST BENGAL,2003,House Wife,0,0,0,0,0,0,0,1402,1414,980,287,4083,4083,WB
WEST BENGAL,2003,Service (Government),0,74,76,52,0,202,0,7,12,9,0,28,230,WB
WEST BENGAL,2003,Service (Private),0,221,290,226,0,737,0,26,47,22,0,95,832,WB
WEST BENGAL,2003,Public Sector Undertaking,0,322,255,369,0,946,0,79,44,18,0,141,1087,WB
WEST BENGAL,2003,Student,41,418,79,0,0,538,61,413,99,0,0,573,1111,WB
WEST BENGAL,2003,Unemployed,0,392,356,9,0,757,0,87,64,0,0,151,908,WB
WEST BENGAL,2003,Self-employed (Business activity),0,217,329,322,74,942,0,35,22,11,0,68,1010,WB
WEST BENGAL,2003,Professional Activity,0,92,121,140,15,368,0,9,6,5,1,21,389,WB
WEST BENGAL,2003,Farming/Agriculture Activity,0,201,394,260,65,920,0,51,48,16,1,116,1036,WB
WEST BENGAL,2003,Retired Person,0,0,0,0,241,241,0,0,0,0,7,7,248,WB
WEST BENGAL,2003,Total,61,2396,2618,1770,579,7424,98,2282,1895,1191,390,5856,13280,WB
WEST BENGAL,2003,Total Salaried,0,617,621,647,0,1885,0,112,103,49,0,264,2149,WB
WEST BENGAL,2003,Total Self-employed,2,765,1118,948,265,3098,4,175,199,135,55,568,3666,WB
A & N ISLANDS,2004,Others (Please Specify),0,5,2,0,1,8,0,4,0,0,0,4,12,AN
A & N ISLANDS,2004,House Wife,0,0,0,0,0,0,0,10,11,3,1,25,25,AN
A & N ISLANDS,2004,Service (Government),0,4,7,7,0,18,0,0,2,0,0,2,20,AN
A & N ISLANDS,2004,Service (Private),0,13,13,6,4,36,0,1,0,0,0,1,37,AN
A & N ISLANDS,2004,Public Sector Undertaking,0,0,0,0,0,0,0,0,0,0,0,0,0,AN
A & N ISLANDS,2004,Student,0,8,0,0,0,8,1,7,0,0,0,8,16,AN
A & N ISLANDS,2004,Unemployed,0,0,0,0,0,0,0,1,0,0,0,1,1,AN
A & N ISLANDS,2004,Self-employed (Business activity),0,2,2,0,0,4,0,0,0,0,0,0,4,AN
A & N ISLANDS,2004,Professional Activity,0,1,0,1,0,2,0,0,0,0,0,0,2,AN
A & N ISLANDS,2004,Farming/Agriculture Activity,0,1,0,0,2,3,0,0,0,0,0,0,3,AN
A & N ISLANDS,2004,Retired Person,0,0,0,0,2,2,0,0,0,0,0,0,2,AN
A & N ISLANDS,2004,Total,0,34,24,14,9,81,1,23,13,3,1,41,122,AN
A & N ISLANDS,2004,Total Salaried,0,17,20,13,4,54,0,1,2,0,0,3,57,AN
A & N ISLANDS,2004,Total Self-employed,0,4,2,1,2,9,0,1,0,0,0,1,10,AN
ANDHRA PRADESH,2004,Others (Please Specify),46,1092,1355,811,397,3701,82,372,274,256,152,1136,4837,AP
ANDHRA PRADESH,2004,House Wife,0,0,0,0,0,0,0,1163,795,264,93,2315,2315,AP
ANDHRA PRADESH,2004,Service (Government),0,81,163,51,5,300,0,5,8,1,0,14,314,AP
ANDHRA PRADESH,2004,Service (Private),4,174,248,171,22,619,0,34,35,11,0,80,699,AP
ANDHRA PRADESH,2004,Public Sector Undertaking,0,20,30,10,3,63,0,5,17,1,0,23,86,AP
ANDHRA PRADESH,2004,Student,37,230,48,0,0,315,43,127,7,0,0,177,492,AP
ANDHRA PRADESH,2004,Unemployed,1,175,239,147,0,562,2,46,18,14,0,80,642,AP
ANDHRA PRADESH,2004,Self-employed (Business activity),4,248,348,205,108,913,0,29,19,18,1,67,980,AP
ANDHRA PRADESH,2004,Professional Activity,1,87,154,60,27,329,1,24,21,23,12,81,410,AP
ANDHRA PRADESH,2004,Farming/Agriculture Activity,2,455,857,687,217,2218,14,154,150,84,46,448,2666,AP
ANDHRA PRADESH,2004,Retired Person,0,0,6,33,23,62,0,0,0,17,6,23,85,AP
ANDHRA PRADESH,2004,Total,95,2562,3448,2175,802,9082,142,1959,1344,689,310,4444,13526,AP
ANDHRA PRADESH,2004,Total Salaried,4,275,441,232,30,982,0,44,60,13,0,117,1099,AP
ANDHRA PRADESH,2004,Total Self-employed,13,1250,1885,1332,446,4926,35,349,278,206,95,963,5889,AP
ARUNACHAL PRADESH,2004,Others (Please Specify),0,0,0,0,0,0,0,0,0,0,0,0,0,AR
ARUNACHAL PRADESH,2004,House Wife,0,0,0,0,0,0,0,7,10,0,0,17,17,AR
ARUNACHAL PRADESH,2004,Service (Government),0,2,7,1,0,10,0,1,0,0,0,1,11,AR
ARUNACHAL PRADESH,2004,Service (Private),0,1,1,0,0,2,0,0,0,0,0,0,2,AR
ARUNACHAL PRADESH,2004,Public Sector Undertaking,0,0,0,0,0,0,0,0,0,0,0,0,0,AR
ARUNACHAL PRADESH,2004,Student,1,4,0,0,0,5,2,3,0,0,0,5,10,AR
ARUNACHAL PRADESH,2004,Unemployed,0,1,1,0,0,2,1,0,2,0,0,3,5,AR
ARUNACHAL PRADESH,2004,Self-employed (Business activity),0,5,6,3,0,14,0,0,0,0,0,0,14,AR
ARUNACHAL PRADESH,2004,Professional Activity,0,0,0,0,0,0,0,0,0,0,0,0,0,AR
ARUNACHAL PRADESH,2004,Farming/Agriculture Activity,0,5,9,2,0,16,1,2,1,0,0,4,20,AR
ARUNACHAL PRADESH,2004,Retired Person,0,0,0,0,0,0,0,0,0,0,0,0,0,AR
ARUNACHAL PRADESH,2004,Total,1,18,24,6,0,49,4,13,13,0,0,30,79,AR
ARUNACHAL PRADESH,2004,Total Salaried,0,3,8,1,0,12,0,1,0,0,0,1,13,AR
ARUNACHAL PRADESH,2004,Total Self-employed,0,10,15,5,0,30,1,2,1,0,0,4,34,AR
ASSAM,2004,Others (Please Specify),17,249,283,135,38,722,6,119,84,26,8,243,965,AS
ASSAM,2004,House Wife,0,0,0,0,0,0,0,212,159,70,5,446,446,AS
ASSAM,2004,Service (Government),0,0,4,6,0,10,0,0,1,1,0,2,12,AS
ASSAM,2004,Service (Private),0,31,26,12,0,69,0,2,6,7,0,15,84,AS
ASSAM,2004,Public Sector Undertaking,0,24,16,9,1,50,0,6,7,2,0,15,65,AS
ASSAM,2004,Student,20,89,4,0,0,113,10,50,2,0,0,62,175,AS
ASSAM,2004,Unemployed,0,50,90,86,11,237,0,33,18,10,1,62,299,AS
ASSAM,2004,Self-employed (Business activity),2,118,122,52,6,300,0,16,16,2,0,34,334,AS
ASSAM,2004,Professional Activity,2,47,64,10,1,124,0,0,0,0,0,0,124,AS
ASSAM,2004,Farming/Agriculture Activity,0,83,155,67,11,316,2,8,3,2,0,15,331,AS
ASSAM,2004,Retired Person,0,0,0,0,4,4,0,0,0,0,0,0,4,AS
ASSAM,2004,Total,41,691,764,377,72,1945,18,446,296,120,14,894,2839,AS
ASSAM,2004,Total Salaried,0,55,46,27,1,129,0,8,14,10,0,32,161,AS
ASSAM,2004,Total Self-employed,18,392,557,246,46,1259,6,94,76,17,4,197,1456,AS
BIHAR,2004,Others (Please Specify),4,19,17,5,9,54,3,10,4,3,4,24,78,BR
BIHAR,2004,House Wife,0,0,0,0,0,0,0,39,40,9,2,90,90,BR
BIHAR,2004,Service (Government),0,0,4,4,0,8,0,0,0,0,0,0,8,BR
BIHAR,2004,Service (Private),0,4,7,4,0,15,0,0,0,1,0,1,16,BR
BIHAR,2004,Public Sector Undertaking,0,1,6,1,0,8,0,0,0,0,0,0,8,BR
BIHAR,2004,Student,7,14,1,0,0,22,5,5,0,0,0,10,32,BR
BIHAR,2004,Unemployed,5,24,11,3,0,43,1,1,4,1,0,7,50,BR
BIHAR,2004,Self-employed (Business activity),0,7,7,2,0,16,0,4,3,0,0,7,23,BR
BIHAR,2004,Professional Activity,0,2,2,2,0,6,0,0,0,0,0,0,6,BR
BIHAR,2004,Farming/Agriculture Activity,0,4,10,6,3,23,0,0,0,0,0,0,23,BR
BIHAR,2004,Retired Person,0,0,11,3,3,17,0,0,0,0,0,0,17,BR
BIHAR,2004,Total,16,75,76,30,15,212,9,59,51,14,6,139,351,BR
BIHAR,2004,Total Salaried,0,5,17,9,0,31,0,0,0,1,0,1,32,BR
BIHAR,2004,Total Self-employed,0,14,19,11,3,47,0,4,3,0,1,8,55,BR
CHANDIGARH,2004,Others (Please Specify),0,4,7,4,1,16,0,0,0,1,0,1,17,CH
CHANDIGARH,2004,House Wife,0,0,0,0,0,0,0,10,2,0,0,12,12,CH
CHANDIGARH,2004,Service (Government),0,0,3,0,0,3,0,0,0,1,0,1,4,CH
CHANDIGARH,2004,Service (Private),0,6,4,1,0,11,0,0,0,0,0,0,11,CH
CHANDIGARH,2004,Public Sector Undertaking,0,0,0,0,0,0,0,0,0,0,0,0,0,CH
CHANDIGARH,2004,Student,0,5,0,0,0,5,0,8,0,0,0,8,13,CH
CHANDIGARH,2004,Unemployed,0,8,3,1,0,12,0,1,0,0,0,1,13,CH
CHANDIGARH,2004,Self-employed (Business activity),0,0,4,0,0,4,0,0,0,0,0,0,4,CH
CHANDIGARH,2004,Professional Activity,0,0,0,1,0,1,0,0,0,0,0,0,1,CH
CHANDIGARH,2004,Farming/Agriculture Activity,0,0,0,0,0,0,0,0,0,0,0,0,0,CH
CHANDIGARH,2004,Retired Person,0,0,0,0,0,0,0,0,0,0,0,0,0,CH
CHANDIGARH,2004,Total,0,23,21,7,1,52,0,19,2,2,0,23,75,CH
CHANDIGARH,2004,Total Salaried,0,6,7,1,0,14,0,0,0,1,0,1,15,CH
CHANDIGARH,2004,Total Self-employed,0,3,9,5,0,17,0,0,0,0,0,0,17,CH
CHHATTISGARH,2004,Others (Please Specify),49,295,434,335,139,1252,64,163,137,65,19,448,1700,CG
CHHATTISGARH,2004,House Wife,0,0,0,0,0,0,1,358,264,114,40,777,777,CG
CHHATTISGARH,2004,Service (Government),0,7,17,10,1,35,0,1,1,0,0,2,37,CG
CHHATTISGARH,2004,Service (Private),0,25,31,22,2,80,0,0,0,2,0,2,82,CG
CHHATTISGARH,2004,Public Sector Undertaking,0,3,7,5,0,15,0,1,0,0,0,1,16,CG
CHHATTISGARH,2004,Student,20,112,6,0,0,138,27,61,0,0,0,88,226,CG
CHHATTISGARH,2004,Unemployed,5,97,55,4,0,161,0,2,1,0,0,3,164,CG
CHHATTISGARH,2004,Self-employed (Business activity),0,19,12,14,0,45,0,0,0,0,0,0,45,CG
CHHATTISGARH,2004,Professional Activity,0,9,20,14,4,47,0,4,1,0,1,6,53,CG
CHHATTISGARH,2004,Farming/Agriculture Activity,3,312,475,303,120,1213,0,64,56,44,18,182,1395,CG
CHHATTISGARH,2004,Retired Person,0,0,0,0,0,0,0,0,0,0,0,0,0,CG
CHHATTISGARH,2004,Total,77,879,1057,707,266,2986,92,654,460,225,78,1509,4495,CG
CHHATTISGARH,2004,Total Salaried,0,35,55,37,3,130,0,2,1,2,0,5,135,CG
CHHATTISGARH,2004,Total Self-employed,12,442,765,553,216,1988,10,121,128,86,33,378,2366,CG
D & N HAVELI,2004,Others (Please Specify),0,1,1,1,2,5,0,0,0,0,0,0,5,DN
D & N HAVELI,2004,House Wife,0,0,0,0,0,0,0,9,5,1,1,16,16,DN
D & N HAVELI,2004,Service (Government),0,0,0,0,0,0,0,0,0,0,0,0,0,DN
D & N HAVELI,2004,Service (Private),0,2,1,1,0,4,0,1,0,0,0,1,5,DN
D & N HAVELI,2004,Public Sector Undertaking,0,0,0,0,0,0,0,0,0,0,0,0,0,DN
D & N HAVELI,2004,Student,0,0,0,0,0,0,0,2,0,0,0,2,2,DN
D & N HAVELI,2004,Unemployed,0,2,1,0,0,3,0,0,0,0,0,0,3,DN
D & N HAVELI,2004,Self-employed (Business activity),0,0,1,0,0,1,0,0,0,0,0,0,1,DN
D & N HAVELI,2004,Professional Activity,0,0,0,0,0,0,0,0,0,0,0,0,0,DN
D & N HAVELI,2004,Farming/Agriculture Activity,0,2,2,2,1,7,0,0,0,0,0,0,7,DN
D & N HAVELI,2004,Retired Person,0,0,0,0,0,0,0,0,0,0,0,0,0,DN
D & N HAVELI,2004,Total,0,7,6,4,3,20,0,12,5,1,1,19,39,DN
D & N HAVELI,2004,Total Salaried,0,2,1,1,0,4,0,1,0,0,0,1,5,DN
D & N HAVELI,2004,Total Self-employed,0,3,4,3,3,13,0,0,0,0,0,0,13,DN
DAMAN & DIU,2004,Others (Please Specify),0,0,2,0,0,2,0,1,0,0,0,1,3,DD
DAMAN & DIU,2004,House Wife,0,0,0,0,0,0,0,5,0,0,0,5,5,DD
DAMAN & DIU,2004,Service (Government),0,0,0,0,0,0,0,0,0,0,0,0,0,DD
DAMAN & DIU,2004,Service (Private),0,1,0,0,0,1,0,2,0,0,0,2,3,DD
DAMAN & DIU,2004,Public Sector Undertaking,0,0,0,0,0,0,0,0,0,0,0,0,0,DD
DAMAN & DIU,2004,Student,0,0,0,0,0,0,0,0,0,0,0,0,0,DD
DAMAN & DIU,2004,Unemployed,0,0,0,0,0,0,0,0,0,0,0,0,0,DD
DAMAN & DIU,2004,Self-employed (Business activity),0,0,0,0,0,0,0,0,0,0,0,0,0,DD
DAMAN & DIU,2004,Professional Activity,0,0,0,0,0,0,0,0,0,0,0,0,0,DD
DAMAN & DIU,2004,Farming/Agriculture Activity,0,0,1,1,0,2,0,0,0,0,0,0,2,DD
DAMAN & DIU,2004,Retired Person,0,0,0,0,0,0,0,0,0,0,0,0,0,DD
DAMAN & DIU,2004,Total,0,1,3,1,0,5,0,8,0,0,0,8,13,DD
DAMAN & DIU,2004,Total Salaried,0,1,0,0,0,1,0,2,0,0,0,2,3,DD
DAMAN & DIU,2004,Total Self-employed,0,0,1,1,0,2,0,0,0,0,0,0,2,DD
DELHI (UT),2004,Others (Please Specify),2,75,87,46,4,214,4,35,18,4,0,61,275,DL
DELHI (UT),2004,House Wife,0,0,0,0,0,0,0,158,78,16,14,266,266,DL
DELHI (UT),2004,Service (Government),0,1,9,4,0,14,0,0,0,0,0,0,14,DL
DELHI (UT),2004,Service (Private),0,88,84,24,3,199,0,4,2,0,0,6,205,DL
DELHI (UT),2004,Public Sector Undertaking,0,5,3,2,1,11,0,3,1,0,0,4,15,DL
DELHI (UT),2004,Student,15,42,0,0,0,57,12,41,0,0,0,53,110,DL
DELHI (UT),2004,Unemployed,2,112,101,33,6,254,1,42,18,3,2,66,320,DL
DELHI (UT),2004,Self-employed (Business activity),0,15,9,6,1,31,0,0,0,0,0,0,31,DL
DELHI (UT),2004,Professional Activity,0,3,2,0,0,5,0,0,0,0,0,0,5,DL
DELHI (UT),2004,Farming/Agriculture Activity,0,1,3,5,3,12,0,0,0,1,0,1,13,DL
DELHI (UT),2004,Retired Person,0,0,0,0,2,2,0,0,0,0,0,0,2,DL
DELHI (UT),2004,Total,19,342,298,120,20,799,17,283,117,24,16,457,1256,DL
DELHI (UT),2004,Total Salaried,0,94,96,30,4,224,0,7,3,0,0,10,234,DL
DELHI (UT),2004,Total Self-employed,1,74,76,37,8,196,3,22,16,3,0,44,240,DL
GOA,2004,Others (Please Specify),4,20,30,13,5,72,2,3,2,1,1,9,81,GA
GOA,2004,House Wife,0,0,0,0,0,0,0,19,22,10,4,55,55,GA
GOA,2004,Service (Government),0,1,4,2,0,7,0,0,1,2,0,3,10,GA
GOA,2004,Service (Private),0,11,19,9,0,39,0,6,0,1,0,7,46,GA
GOA,2004,Public Sector Undertaking,0,4,3,3,0,10,0,0,3,0,0,3,13,GA
GOA,2004,Student,2,11,0,0,0,13,3,7,0,0,0,10,23,GA
GOA,2004,Unemployed,0,20,19,8,1,48,0,9,1,0,1,11,59,GA
GOA,2004,Self-employed (Business activity),0,6,4,2,0,12,0,1,1,0,0,2,14,GA
GOA,2004,Professional Activity,0,0,1,0,0,1,0,1,0,0,0,1,2,GA
GOA,2004,Farming/Agriculture Activity,0,0,2,5,0,7,0,0,1,0,0,1,8,GA
GOA,2004,Retired Person,0,0,0,2,1,3,0,0,0,0,0,0,3,GA
GOA,2004,Total,6,73,82,44,7,212,5,46,31,14,6,102,314,GA
GOA,2004,Total Salaried,0,16,26,14,0,56,0,6,4,3,0,13,69,GA
GOA,2004,Total Self-employed,0,8,12,9,1,30,0,2,2,0,0,4,34,GA
GUJARAT,2004,Others (Please Specify),18,243,270,146,44,721,10,108,40,19,14,191,912,GJ
GUJARAT,2004,House Wife,0,0,0,0,0,0,6,616,489,190,59,1360,1360,GJ
GUJARAT,2004,Service (Government),0,15,30,15,0,60,0,1,4,1,0,6,66,GJ
GUJARAT,2004,Service (Private),0,107,153,81,10,351,0,40,19,9,1,69,420,GJ
GUJARAT,2004,Public Sector Undertaking,0,9,14,16,2,41,0,1,1,0,0,2,43,GJ
GUJARAT,2004,Student,15,115,10,0,0,140,13,92,1,0,1,107,247,GJ
GUJARAT,2004,Unemployed,1,171,170,73,10,425,0,27,19,6,0,52,477,GJ
GUJARAT,2004,Self-employed (Business activity),0,71,96,57,10,234,0,1,3,1,1,6,240,GJ
GUJARAT,2004,Professional Activity,0,123,141,85,16,365,0,10,8,2,1,21,386,GJ
GUJARAT,2004,Farming/Agriculture Activity,0,134,153,123,42,452,0,31,20,18,2,71,523,GJ
GUJARAT,2004,Retired Person,0,0,0,15,46,61,0,0,0,11,30,41,102,GJ
GUJARAT,2004,Total,34,988,1037,611,180,2850,29,927,604,257,109,1926,4776,GJ
GUJARAT,2004,Total Salaried,0,131,197,112,12,452,0,42,24,10,1,77,529,GJ
GUJARAT,2004,Total Self-employed,4,491,574,362,97,1528,5,111,61,29,11,217,1745,GJ
HARYANA,2004,Others (Please Specify),25,210,222,100,67,624,7,70,50,22,8,157,781,HR
HARYANA,2004,House Wife,0,0,0,0,0,0,1,157,120,37,15,330,330,HR
HARYANA,2004,Service (Government),0,20,28,19,0,67,0,11,4,1,0,16,83,HR
HARYANA,2004,Service (Private),0,62,82,26,2,172,0,27,8,2,0,37,209,HR
HARYANA,2004,Public Sector Undertaking,0,13,32,5,0,50,0,3,6,1,0,10,60,HR
HARYANA,2004,Student,5,71,3,0,0,79,11,27,0,0,0,38,117,HR
HARYANA,2004,Unemployed,4,71,72,34,6,187,3,6,10,5,0,24,211,HR
HARYANA,2004,Self-employed (Business activity),0,28,30,20,11,89,0,0,0,0,0,0,89,HR
HARYANA,2004,Professional Activity,0,1,19,13,0,33,0,0,0,0,0,0,33,HR
HARYANA,2004,Farming/Agriculture Activity,0,40,56,38,10,144,0,6,6,4,0,16,160,HR
HARYANA,2004,Retired Person,0,0,0,0,9,9,0,0,0,0,0,0,9,HR
HARYANA,2004,Total,34,516,544,255,105,1454,22,307,204,72,23,628,2082,HR
HARYANA,2004,Total Salaried,0,95,142,50,2,289,0,41,18,4,0,63,352,HR
HARYANA,2004,Total Self-employed,4,124,174,111,29,442,2,14,25,13,2,56,498,HR
HIMACHAL PRADESH,2004,Others (Please Specify),0,5,30,27,10,72,2,5,12,3,1,23,95,HP
HIMACHAL PRADESH,2004,House Wife,0,0,0,0,0,0,0,40,24,9,2,75,75,HP
HIMACHAL PRADESH,2004,Service (Government),0,6,4,3,0,13,0,0,0,1,0,1,14,HP
HIMACHAL PRADESH,2004,Service (Private),1,21,21,4,2,49,0,1,1,0,0,2,51,HP
HIMACHAL PRADESH,2004,Public Sector Undertaking,0,1,0,1,0,2,0,0,0,0,0,0,2,HP
HIMACHAL PRADESH,2004,Student,4,7,0,0,0,11,2,9,1,0,0,12,23,HP
HIMACHAL PRADESH,2004,Unemployed,0,18,10,2,4,34,0,12,0,0,0,12,46,HP
HIMACHAL PRADESH,2004,Self-employed (Business activity),0,5,3,3,0,11,0,1,0,0,0,1,12,HP
HIMACHAL PRADESH,2004,Professional Activity,0,0,0,1,0,1,0,0,0,0,0,0,1,HP
HIMACHAL PRADESH,2004,Farming/Agriculture Activity,0,14,14,13,2,43,0,3,4,1,1,9,52,HP
HIMACHAL PRADESH,2004,Retired Person,0,0,0,0,0,0,0,0,0,0,0,0,0,HP
HIMACHAL PRADESH,2004,Total,5,77,82,54,18,236,4,71,42,14,4,135,371,HP
HIMACHAL PRADESH,2004,Total Salaried,1,28,25,8,2,64,0,1,1,1,0,3,67,HP
HIMACHAL PRADESH,2004,Total Self-employed,0,24,32,25,3,84,0,9,9,1,1,20,104,HP
JAMMU & KASHMIR,2004,Others (Please Specify),0,16,14,7,0,37,0,12,13,3,0,28,65,JK
JAMMU & KASHMIR,2004,House Wife,0,0,0,0,0,0,0,13,16,0,0,29,29,JK
JAMMU & KASHMIR,2004,Service (Government),0,2,2,0,0,4,0,0,0,0,0,0,4,JK
JAMMU & KASHMIR,2004,Service (Private),0,0,0,0,0,0,0,0,0,0,0,0,0,JK
JAMMU & KASHMIR,2004,Public Sector Undertaking,0,0,0,0,0,0,0,1,0,0,0,1,1,JK
JAMMU & KASHMIR,2004,Student,0,3,0,0,0,3,0,3,0,0,0,3,6,JK
JAMMU & KASHMIR,2004,Unemployed,0,6,0,0,0,6,0,0,0,0,0,0,6,JK
JAMMU & KASHMIR,2004,Self-employed (Business activity),0,0,0,0,0,0,0,0,0,0,0,0,0,JK
JAMMU & KASHMIR,2004,Professional Activity,0,0,0,0,0,0,0,0,0,0,0,0,0,JK
JAMMU & KASHMIR,2004,Farming/Agriculture Activity,0,0,0,1,0,1,0,0,0,0,0,0,1,JK
JAMMU & KASHMIR,2004,Retired Person,0,0,0,0,0,0,0,0,0,0,0,0,0,JK
JAMMU & KASHMIR,2004,Total,0,27,16,8,0,51,0,29,29,3,0,61,112,JK
JAMMU & KASHMIR,2004,Total Salaried,0,2,2,0,0,4,0,1,0,0,0,1,5,JK
JAMMU & KASHMIR,2004,Total Self-employed,0,0,5,1,0,6,0,4,5,1,0,10,16,JK
JHARKHAND,2004,Others (Please Specify),6,52,49,42,9,158,4,61,63,44,0,172,330,JH
JHARKHAND,2004,House Wife,0,0,0,0,0,0,0,0,0,0,0,0,0,JH
JHARKHAND,2004,Service (Government),0,0,0,0,0,0,0,0,0,0,0,0,0,JH
JHARKHAND,2004,Service (Private),0,0,4,1,0,5,0,0,3,0,0,3,8,JH
JHARKHAND,2004,Public Sector Undertaking,0,0,2,1,0,3,0,0,2,1,0,3,6,JH
JHARKHAND,2004,Student,3,4,0,0,0,7,0,3,0,0,0,3,10,JH
JHARKHAND,2004,Unemployed,0,8,8,11,0,27,0,1,1,0,0,2,29,JH
JHARKHAND,2004,Self-employed (Business activity),0,0,2,1,0,3,0,0,1,0,0,1,4,JH
JHARKHAND,2004,Professional Activity,0,4,1,2,2,9,0,0,0,0,0,0,9,JH
JHARKHAND,2004,Farming/Agriculture Activity,0,4,14,3,0,21,0,0,0,0,0,0,21,JH
JHARKHAND,2004,Retired Person,0,0,0,0,0,0,0,0,0,0,0,0,0,JH
JHARKHAND,2004,Total,9,72,80,61,11,233,4,65,70,45,0,184,417,JH
JHARKHAND,2004,Total Salaried,0,0,6,2,0,8,0,0,5,1,0,6,14,JH
JHARKHAND,2004,Total Self-employed,0,26,27,12,2,67,0,10,1,2,0,13,80,JH
KARNATAKA,2004,Others (Please Specify),95,959,1306,937,405,3702,87,509,375,193,90,1254,4956,KA
KARNATAKA,2004,House Wife,0,0,0,0,0,0,0,736,609,300,138,1783,1783,KA
KARNATAKA,2004,Service (Government),0,38,65,58,4,165,0,21,10,3,0,34,199,KA
KARNATAKA,2004,Service (Private),5,286,358,192,46,887,1,104,77,29,7,218,1105,KA
KARNATAKA,2004,Public Sector Undertaking,0,55,78,29,7,169,0,30,10,9,0,49,218,KA
KARNATAKA,2004,Student,45,162,25,0,0,232,48,162,6,0,0,216,448,KA
KARNATAKA,2004,Unemployed,4,179,185,101,57,526,2,38,24,7,14,85,611,KA
KARNATAKA,2004,Self-employed (Business activity),9,153,207,82,20,471,3,4,8,8,0,23,494,KA
KARNATAKA,2004,Professional Activity,0,33,35,14,3,85,0,0,0,0,0,0,85,KA
KARNATAKA,2004,Farming/Agriculture Activity,1,464,661,432,148,1706,5,84,112,48,8,257,1963,KA
KARNATAKA,2004,Retired Person,0,0,8,17,50,75,0,0,0,0,0,0,75,KA
KARNATAKA,2004,Total,159,2329,2928,1862,740,8018,146,1688,1231,597,257,3919,11937,KA
KARNATAKA,2004,Total Salaried,5,379,501,279,57,1221,1,155,97,41,7,301,1522,KA
KARNATAKA,2004,Total Self-employed,26,1251,1685,1007,348,4317,52,309,364,142,50,917,5234,KA
KERALA,2004,Others (Please Specify),9,511,1164,1238,714,3636,15,139,91,64,82,391,4027,KL
KERALA,2004,House Wife,0,0,0,0,0,0,0,288,484,413,328,1513,1513,KL
KERALA,2004,Service (Government),0,4,39,40,0,83,0,1,3,1,0,5,88,KL
KERALA,2004,Service (Private),0,38,101,70,11,220,0,13,9,4,2,28,248,KL
KERALA,2004,Public Sector Undertaking,0,6,17,8,0,31,0,1,3,3,1,8,39,KL
KERALA,2004,Student,37,106,0,0,0,143,38,153,2,0,0,193,336,KL
KERALA,2004,Unemployed,2,282,299,208,215,1006,0,123,47,32,56,258,1264,KL
KERALA,2004,Self-employed (Business activity),0,48,150,153,34,385,0,0,0,1,0,1,386,KL
KERALA,2004,Professional Activity,0,39,57,46,8,150,0,4,2,0,0,6,156,KL
KERALA,2004,Farming/Agriculture Activity,0,73,240,330,217,860,0,7,13,17,6,43,903,KL
KERALA,2004,Retired Person,0,0,0,17,67,84,0,0,0,1,8,9,93,KL
KERALA,2004,Total,48,1107,2067,2110,1266,6598,53,729,654,536,483,2455,9053,KL
KERALA,2004,Total Salaried,0,48,157,118,11,334,0,15,15,8,3,41,375,KL
KERALA,2004,Total Self-employed,2,516,1221,1449,741,3929,7,102,58,55,55,277,4206,KL
LAKSHADWEEP,2004,Others (Please Specify),0,0,0,0,0,0,0,0,0,0,0,0,0,LD
LAKSHADWEEP,2004,House Wife,0,0,0,0,0,0,0,0,0,0,0,0,0,LD
LAKSHADWEEP,2004,Service (Government),0,0,0,0,0,0,0,0,0,0,0,0,0,LD
LAKSHADWEEP,2004,Service (Private),0,0,0,0,0,0,0,0,0,0,0,0,0,LD
LAKSHADWEEP,2004,Public Sector Undertaking,0,0,0,0,0,0,0,0,0,0,0,0,0,LD
LAKSHADWEEP,2004,Student,0,0,0,0,0,0,0,0,0,0,0,0,0,LD
LAKSHADWEEP,2004,Unemployed,0,0,0,0,0,0,0,0,0,0,0,0,0,LD
LAKSHADWEEP,2004,Self-employed (Business activity),0,0,0,0,0,0,0,0,0,0,0,0,0,LD
LAKSHADWEEP,2004,Professional Activity,0,0,0,0,0,0,0,0,0,0,0,0,0,LD
LAKSHADWEEP,2004,Farming/Agriculture Activity,0,0,0,0,0,0,0,0,0,0,0,0,0,LD
LAKSHADWEEP,2004,Retired Person,0,0,0,0,0,0,0,0,0,0,0,0,0,LD
LAKSHADWEEP,2004,Total,0,0,0,0,0,0,0,0,0,0,0,0,0,LD
LAKSHADWEEP,2004,Total Salaried,0,0,0,0,0,0,0,0,0,0,0,0,0,LD
LAKSHADWEEP,2004,Total Self-employed,0,0,0,0,0,0,0,0,0,0,0,0,0,LD
MADHYA PRADESH,2004,Others (Please Specify),42,260,293,150,94,839,63,153,63,61,44,384,1223,MP
MADHYA PRADESH,2004,House Wife,0,0,0,0,0,0,0,1244,584,198,86,2112,2112,MP
MADHYA PRADESH,2004,Service (Government),0,62,70,31,7,170,0,15,13,6,0,34,204,MP
MADHYA PRADESH,2004,Service (Private),1,115,142,65,11,334,0,39,21,1,0,61,395,MP
MADHYA PRADESH,2004,Public Sector Undertaking,0,33,42,15,9,99,0,29,21,1,0,51,150,MP
MADHYA PRADESH,2004,Student,64,88,1,0,0,153,38,73,0,0,0,111,264,MP
MADHYA PRADESH,2004,Unemployed,1,159,70,20,0,250,0,20,11,1,0,32,282,MP
MADHYA PRADESH,2004,Self-employed (Business activity),0,85,97,55,30,267,0,31,15,8,4,58,325,MP
MADHYA PRADESH,2004,Professional Activity,0,42,46,57,16,161,0,6,8,7,6,27,188,MP
MADHYA PRADESH,2004,Farming/Agriculture Activity,1,564,441,202,139,1347,9,143,83,38,18,291,1638,MP
MADHYA PRADESH,2004,Retired Person,0,0,0,0,14,14,0,0,0,0,0,0,14,MP
MADHYA PRADESH,2004,Total,109,1408,1202,595,320,3634,110,1753,819,321,158,3161,6795,MP
MADHYA PRADESH,2004,Total Salaried,1,210,254,111,27,603,0,83,55,8,0,146,749,MP
MADHYA PRADESH,2004,Total Self-employed,19,884,801,440,268,2412,57,298,158,109,71,693,3105,MP
MAHARASHTRA,2004,Others (Please Specify),7,530,744,465,188,1934,7,145,73,30,28,283,2217,MH
MAHARASHTRA,2004,House Wife,0,0,0,0,0,0,0,1768,1096,422,215,3501,3501,MH
MAHARASHTRA,2004,Service (Government),0,38,97,66,0,201,0,23,13,7,0,43,244,MH
MAHARASHTRA,2004,Service (Private),0,403,599,300,43,1345,0,61,30,9,1,101,1446,MH
MAHARASHTRA,2004,Public Sector Undertaking,0,46,62,40,6,154,0,4,2,3,0,9,163,MH
MAHARASHTRA,2004,Student,77,427,12,0,0,516,81,357,5,0,0,443,959,MH
MAHARASHTRA,2004,Unemployed,0,514,396,99,9,1018,2,46,11,1,0,60,1078,MH
MAHARASHTRA,2004,Self-employed (Business activity),0,134,201,130,40,505,0,9,12,5,1,27,532,MH
MAHARASHTRA,2004,Professional Activity,0,79,123,82,26,310,0,5,4,0,0,9,319,MH
MAHARASHTRA,2004,Farming/Agriculture Activity,3,909,1504,940,443,3799,3,155,107,59,24,348,4147,MH
MAHARASHTRA,2004,Retired Person,0,0,0,16,105,121,0,0,0,0,2,2,123,MH
MAHARASHTRA,2004,Total,87,3080,3738,2138,860,9903,93,2573,1353,536,271,4826,14729,MH
MAHARASHTRA,2004,Total Salaried,0,487,758,406,49,1700,0,88,45,19,1,153,1853,MH
MAHARASHTRA,2004,Total Self-employed,10,1639,2543,1608,677,6477,8,305,194,93,49,649,7126,MH
MANIPUR,2004,Others (Please Specify),0,2,1,0,0,3,0,0,0,0,0,0,3,MN
MANIPUR,2004,House Wife,0,0,0,0,0,0,0,0,1,0,0,1,1,MN
MANIPUR,2004,Service (Government),0,4,7,1,0,12,0,0,0,0,0,0,12,MN
MANIPUR,2004,Service (Private),0,0,1,0,0,1,0,0,0,0,0,0,1,MN
MANIPUR,2004,Public Sector Undertaking,0,0,0,0,0,0,0,0,0,0,0,0,0,MN
MANIPUR,2004,Student,0,4,0,0,0,4,1,5,0,0,0,6,10,MN
MANIPUR,2004,Unemployed,0,5,1,1,0,7,0,0,2,0,0,2,9,MN
MANIPUR,2004,Self-employed (Business activity),0,2,1,0,0,3,0,0,0,0,0,0,3,MN
MANIPUR,2004,Professional Activity,0,0,0,0,0,0,0,0,0,0,0,0,0,MN
MANIPUR,2004,Farming/Agriculture Activity,0,0,1,1,0,2,0,0,0,0,0,0,2,MN
MANIPUR,2004,Retired Person,0,0,0,0,0,0,0,0,0,0,0,0,0,MN
MANIPUR,2004,Total,0,17,12,3,0,32,1,5,3,0,0,9,41,MN
MANIPUR,2004,Total Salaried,0,4,8,1,0,13,0,0,0,0,0,0,13,MN
MANIPUR,2004,Total Self-employed,0,3,2,1,0,6,0,0,0,0,0,0,6,MN
MEGHALAYA,2004,Others (Please Specify),0,0,0,0,0,0,0,0,0,0,0,0,0,ML
MEGHALAYA,2004,House Wife,0,0,0,0,0,0,0,5,2,0,0,7,7,ML
MEGHALAYA,2004,Service (Government),0,0,8,2,0,10,0,1,0,0,0,1,11,ML
MEGHALAYA,2004,Service (Private),0,3,3,0,0,6,0,0,0,0,0,0,6,ML
MEGHALAYA,2004,Public Sector Undertaking,0,1,1,0,0,2,0,0,0,0,0,0,2,ML
MEGHALAYA,2004,Student,0,6,0,0,0,6,0,6,0,0,0,6,12,ML
MEGHALAYA,2004,Unemployed,0,1,3,0,0,4,0,2,0,0,0,2,6,ML
MEGHALAYA,2004,Self-employed (Business activity),0,0,0,0,0,0,0,0,0,0,0,0,0,ML
MEGHALAYA,2004,Professional Activity,0,0,0,0,0,0,0,0,0,0,0,0,0,ML
MEGHALAYA,2004,Farming/Agriculture Activity,0,0,3,6,2,11,0,0,0,0,0,0,11,ML
MEGHALAYA,2004,Retired Person,0,0,0,0,0,0,0,0,0,0,0,0,0,ML
MEGHALAYA,2004,Total,0,11,18,8,2,39,0,14,2,0,0,16,55,ML
MEGHALAYA,2004,Total Salaried,0,4,12,2,0,18,0,1,0,0,0,1,19,ML
MEGHALAYA,2004,Total Self-employed,0,0,3,6,2,11,0,0,0,0,0,0,11,ML
MIZORAM,2004,Others (Please Specify),0,14,6,3,0,23,0,3,1,0,0,4,27,MZ
MIZORAM,2004,House Wife,0,0,0,0,0,0,0,0,0,0,0,0,0,MZ
MIZORAM,2004,Service (Government),0,3,1,0,0,4,0,0,0,0,0,0,4,MZ
MIZORAM,2004,Service (Private),0,0,0,0,0,0,0,0,0,0,0,0,0,MZ
MIZORAM,2004,Public Sector Undertaking,0,0,4,1,0,5,0,0,0,0,0,0,5,MZ
MIZORAM,2004,Student,0,1,0,0,0,1,0,0,0,0,0,0,1,MZ
MIZORAM,2004,Unemployed,0,11,5,2,0,18,0,3,0,0,0,3,21,MZ
MIZORAM,2004,Self-employed (Business activity),0,0,0,0,0,0,0,0,0,0,0,0,0,MZ
MIZORAM,2004,Professional Activity,0,0,0,0,0,0,0,0,0,0,0,0,0,MZ
MIZORAM,2004,Farming/Agriculture Activity,0,0,1,1,0,2,0,0,0,0,0,0,2,MZ
MIZORAM,2004,Retired Person,0,0,0,0,0,0,0,0,0,0,0,0,0,MZ
MIZORAM,2004,Total,0,29,17,7,0,53,0,6,1,0,0,7,60,MZ
MIZORAM,2004,Total Salaried,0,3,5,1,0,9,0,0,0,0,0,0,9,MZ
MIZORAM,2004,Total Self-employed,0,8,7,2,0,17,0,3,0,0,0,3,20,MZ
NAGALAND,2004,Others (Please Specify),0,4,5,2,0,11,0,4,2,0,0,6,17,NG
NAGALAND,2004,House Wife,0,0,0,0,0,0,0,0,0,0,0,0,0,NG
NAGALAND,2004,Service (Government),0,1,5,0,0,6,0,0,0,0,0,0,6,NG
NAGALAND,2004,Service (Private),0,0,0,0,0,0,0,0,0,0,0,0,0,NG
NAGALAND,2004,Public Sector Undertaking,0,2,0,0,0,2,0,0,0,0,0,0,2,NG
NAGALAND,2004,Student,0,1,0,0,0,1,0,0,0,0,0,0,1,NG
NAGALAND,2004,Unemployed,0,2,3,0,0,5,0,0,0,0,0,0,5,NG
NAGALAND,2004,Self-employed (Business activity),0,0,0,0,0,0,0,0,0,0,0,0,0,NG
NAGALAND,2004,Professional Activity,0,0,0,0,0,0,0,0,0,0,0,0,0,NG
NAGALAND,2004,Farming/Agriculture Activity,0,0,0,0,0,0,0,0,0,0,0,0,0,NG
NAGALAND,2004,Retired Person,0,0,0,0,0,0,0,0,0,0,0,0,0,NG
NAGALAND,2004,Total,0,10,13,2,0,25,0,4,2,0,0,6,31,NG
NAGALAND,2004,Total Salaried,0,3,5,0,0,8,0,0,0,0,0,0,8,NG
NAGALAND,2004,Total Self-employed,0,4,5,2,0,11,0,4,2,0,0,6,17,NG
ODISHA,2004,Others (Please Specify),40,337,409,341,117,1244,37,284,165,81,55,622,1866,OD
ODISHA,2004,House Wife,0,0,0,0,0,0,0,291,214,103,12,620,620,OD
ODISHA,2004,Service (Government),0,9,16,10,0,35,0,1,3,2,0,6,41,OD
ODISHA,2004,Service (Private),0,30,75,52,5,162,0,25,20,4,10,59,221,OD
ODISHA,2004,Public Sector Undertaking,0,22,24,24,0,70,0,9,9,3,0,21,91,OD
ODISHA,2004,Student,36,91,18,0,0,145,28,87,6,0,0,121,266,OD
ODISHA,2004,Unemployed,8,99,102,37,1,247,13,46,29,15,1,104,351,OD
ODISHA,2004,Self-employed (Business activity),0,61,124,56,10,251,0,8,10,2,0,20,271,OD
ODISHA,2004,Professional Activity,0,10,27,20,4,61,0,0,7,0,4,11,72,OD
ODISHA,2004,Farming/Agriculture Activity,0,88,109,75,27,299,1,34,33,10,2,80,379,OD
ODISHA,2004,Retired Person,0,0,0,1,29,30,0,0,0,7,0,7,37,OD
ODISHA,2004,Total,84,747,904,616,193,2544,79,785,496,227,84,1671,4215,OD
ODISHA,2004,Total Salaried,0,61,115,86,5,267,0,35,32,9,10,86,353,OD
ODISHA,2004,Total Self-employed,22,398,530,411,141,1502,27,270,160,66,38,561,2063,OD
PUDUCHERRY,2004,Others (Please Specify),0,9,30,16,3,58,0,0,2,0,0,2,60,PY
PUDUCHERRY,2004,House Wife,0,0,0,0,0,0,0,38,45,14,8,105,105,PY
PUDUCHERRY,2004,Service (Government),0,1,7,11,0,19,0,2,0,2,0,4,23,PY
PUDUCHERRY,2004,Service (Private),0,13,10,5,0,28,0,3,0,0,0,3,31,PY
PUDUCHERRY,2004,Public Sector Undertaking,0,0,0,0,0,0,0,0,0,0,0,0,0,PY
PUDUCHERRY,2004,Student,1,7,0,0,0,8,4,17,0,0,0,21,29,PY
PUDUCHERRY,2004,Unemployed,0,21,9,9,19,58,0,26,6,2,5,39,97,PY
PUDUCHERRY,2004,Self-employed (Business activity),0,3,8,8,0,19,0,0,1,0,0,1,20,PY
PUDUCHERRY,2004,Professional Activity,0,7,13,3,2,25,0,0,0,0,0,0,25,PY
PUDUCHERRY,2004,Farming/Agriculture Activity,0,21,44,48,6,119,0,11,11,2,2,26,145,PY
PUDUCHERRY,2004,Retired Person,0,0,0,2,2,4,0,0,0,0,0,0,4,PY
PUDUCHERRY,2004,Total,1,82,121,102,32,338,4,97,65,20,15,201,539,PY
PUDUCHERRY,2004,Total Salaried,0,14,17,16,0,47,0,5,0,2,0,7,54,PY
PUDUCHERRY,2004,Total Self-employed,0,32,70,65,9,176,0,11,13,2,2,28,204,PY
PUNJAB,2004,Others (Please Specify),0,107,93,32,29,261,1,7,8,10,0,26,287,PN
PUNJAB,2004,House Wife,0,0,0,0,0,0,0,29,25,3,5,62,62,PN
PUNJAB,2004,Service (Government),0,4,11,1,0,16,0,0,0,0,0,0,16,PN
PUNJAB,2004,Service (Private),0,14,11,6,0,31,2,6,2,0,0,10,41,PN
PUNJAB,2004,Public Sector Undertaking,0,4,12,2,0,18,0,3,0,0,0,3,21,PN
PUNJAB,2004,Student,4,5,0,0,0,9,11,6,0,0,0,17,26,PN
PUNJAB,2004,Unemployed,0,13,10,23,0,46,0,6,4,0,0,10,56,PN
PUNJAB,2004,Self-employed (Business activity),0,7,9,12,0,28,0,0,0,0,0,0,28,PN
PUNJAB,2004,Professional Activity,0,11,8,5,2,26,0,0,0,0,0,0,26,PN
PUNJAB,2004,Farming/Agriculture Activity,0,21,29,18,5,73,0,1,0,0,0,1,74,PN
PUNJAB,2004,Retired Person,0,0,0,5,3,8,0,0,0,0,0,0,8,PN
PUNJAB,2004,Total,4,186,183,104,39,516,14,58,39,13,5,129,645,PN
PUNJAB,2004,Total Salaried,0,22,34,9,0,65,2,9,2,0,0,13,78,PN
PUNJAB,2004,Total Self-employed,0,93,107,56,23,279,0,3,2,0,0,5,284,PN
RAJASTHAN,2004,Others (Please Specify),35,333,347,241,93,1049,23,90,51,29,16,209,1258,RJ
RAJASTHAN,2004,House Wife,0,0,0,0,0,0,10,370,333,123,32,868,868,RJ
RAJASTHAN,2004,Service (Government),0,4,13,7,0,24,0,1,1,0,0,2,26,RJ
RAJASTHAN,2004,Service (Private),0,103,126,47,2,278,0,12,6,6,0,24,302,RJ
RAJASTHAN,2004,Public Sector Undertaking,0,19,13,5,0,37,0,2,2,0,0,4,41,RJ
RAJASTHAN,2004,Student,30,60,8,0,0,98,10,36,3,0,0,49,147,RJ
RAJASTHAN,2004,Unemployed,0,85,79,14,4,182,0,3,1,1,0,5,187,RJ
RAJASTHAN,2004,Self-employed (Business activity),0,29,48,22,10,109,0,1,1,2,0,4,113,RJ
RAJASTHAN,2004,Professional Activity,0,11,11,7,3,32,0,0,0,0,0,0,32,RJ
RAJASTHAN,2004,Farming/Agriculture Activity,1,207,286,154,27,675,0,27,29,14,4,74,749,RJ
RAJASTHAN,2004,Retired Person,0,0,0,2,0,2,0,0,0,0,0,0,2,RJ
RAJASTHAN,2004,Total,66,851,931,499,139,2486,43,542,427,175,52,1239,3725,RJ
RAJASTHAN,2004,Total Salaried,0,126,152,59,2,339,0,15,9,6,0,30,369,RJ
RAJASTHAN,2004,Total Self-employed,6,409,502,296,74,1287,3,71,49,33,6,162,1449,RJ
SIKKIM,2004,Others (Please Specify),0,0,2,4,3,9,0,0,1,0,5,6,15,SK
SIKKIM,2004,House Wife,0,0,0,0,0,0,0,0,2,7,2,11,11,SK
SIKKIM,2004,Service (Government),0,0,3,0,0,3,0,0,0,0,0,0,3,SK
SIKKIM,2004,Service (Private),0,0,4,2,0,6,0,0,0,0,0,0,6,SK
SIKKIM,2004,Public Sector Undertaking,0,0,0,0,0,0,0,0,0,0,0,0,0,SK
SIKKIM,2004,Student,0,0,0,0,0,0,0,0,0,0,0,0,0,SK
SIKKIM,2004,Unemployed,0,0,2,0,0,2,0,0,2,0,2,4,6,SK
SIKKIM,2004,Self-employed (Business activity),0,0,0,0,0,0,0,0,0,0,0,0,0,SK
SIKKIM,2004,Professional Activity,0,0,3,1,2,6,0,0,0,1,1,2,8,SK
SIKKIM,2004,Farming/Agriculture Activity,0,0,3,6,21,30,0,0,4,7,8,19,49,SK
SIKKIM,2004,Retired Person,0,0,0,0,0,0,0,0,0,0,0,0,0,SK
SIKKIM,2004,Total,0,0,17,13,26,56,0,0,9,15,18,42,98,SK
SIKKIM,2004,Total Salaried,0,0,7,2,0,9,0,0,0,0,0,0,9,SK
SIKKIM,2004,Total Self-employed,0,0,6,9,26,41,0,0,4,8,14,26,67,SK
TAMIL NADU,2004,Others (Please Specify),97,620,988,755,311,2771,102,474,357,267,95,1295,4066,TN
TAMIL NADU,2004,House Wife,0,0,0,0,0,0,0,698,766,485,163,2112,2112,TN
TAMIL NADU,2004,Service (Government),0,34,67,54,0,155,0,3,18,23,0,44,199,TN
TAMIL NADU,2004,Service (Private),0,215,301,268,48,832,3,83,102,57,6,251,1083,TN
TAMIL NADU,2004,Public Sector Undertaking,0,60,94,63,10,227,0,13,30,23,7,73,300,TN
TAMIL NADU,2004,Student,74,158,15,0,0,247,55,163,7,1,0,226,473,TN
TAMIL NADU,2004,Unemployed,7,358,435,350,91,1241,3,207,137,93,18,458,1699,TN
TAMIL NADU,2004,Self-employed (Business activity),3,180,294,271,64,812,0,23,18,17,0,58,870,TN
TAMIL NADU,2004,Professional Activity,2,77,102,75,19,275,0,26,22,8,1,57,332,TN
TAMIL NADU,2004,Farming/Agriculture Activity,7,318,457,329,186,1297,13,124,98,45,22,302,1599,TN
TAMIL NADU,2004,Retired Person,0,0,0,5,84,89,0,0,0,2,15,17,106,TN
TAMIL NADU,2004,Total,190,2020,2753,2170,813,7946,176,1814,1555,1021,327,4893,12839,TN
TAMIL NADU,2004,Total Salaried,0,309,462,385,58,1214,3,99,150,103,13,368,1582,TN
TAMIL NADU,2004,Total Self-employed,18,947,1350,1035,460,3810,19,394,301,212,61,987,4797,TN
TRIPURA,2004,Others (Please Specify),1,51,37,22,2,113,0,9,15,5,2,31,144,TR
TRIPURA,2004,House Wife,0,0,0,0,0,0,4,85,51,7,5,152,152,TR
TRIPURA,2004,Service (Government),0,3,5,0,0,8,0,0,3,0,0,3,11,TR
TRIPURA,2004,Service (Private),0,2,4,3,2,11,0,0,3,0,0,3,14,TR
TRIPURA,2004,Public Sector Undertaking,0,0,2,2,0,4,0,0,0,0,0,0,4,TR
TRIPURA,2004,Student,4,42,0,0,0,46,18,46,0,0,0,64,110,TR
TRIPURA,2004,Unemployed,0,73,57,39,5,174,0,41,33,8,0,82,256,TR
TRIPURA,2004,Self-employed (Business activity),0,12,11,5,3,31,0,2,0,0,0,2,33,TR
TRIPURA,2004,Professional Activity,0,16,11,4,0,31,0,0,0,0,0,0,31,TR
TRIPURA,2004,Farming/Agriculture Activity,0,5,7,2,1,15,0,0,0,0,0,0,15,TR
TRIPURA,2004,Retired Person,0,0,0,0,0,0,0,0,0,0,0,0,0,TR
TRIPURA,2004,Total,5,204,134,77,13,433,22,183,105,20,7,337,770,TR
TRIPURA,2004,Total Salaried,0,5,11,5,2,23,0,0,6,0,0,6,29,TR
TRIPURA,2004,Total Self-employed,0,55,45,17,6,123,0,5,7,1,2,15,138,TR
UTTAR PRADESH,2004,Others (Please Specify),47,203,189,132,77,648,19,66,45,43,27,200,848,UP
UTTAR PRADESH,2004,House Wife,0,0,0,0,0,0,26,643,290,104,27,1090,1090,UP
UTTAR PRADESH,2004,Service (Government),0,12,13,5,0,30,0,2,0,0,0,2,32,UP
UTTAR PRADESH,2004,Service (Private),0,54,75,23,3,155,0,32,29,12,0,73,228,UP
UTTAR PRADESH,2004,Public Sector Undertaking,0,42,26,13,2,83,0,14,14,9,0,37,120,UP
UTTAR PRADESH,2004,Student,28,92,8,0,0,128,20,53,0,0,0,73,201,UP
UTTAR PRADESH,2004,Unemployed,2,135,103,42,13,295,2,57,27,3,3,92,387,UP
UTTAR PRADESH,2004,Self-employed (Business activity),0,38,54,24,1,117,0,3,5,2,0,10,127,UP
UTTAR PRADESH,2004,Professional Activity,0,33,26,21,0,80,0,1,5,1,0,7,87,UP
UTTAR PRADESH,2004,Farming/Agriculture Activity,8,128,151,93,21,401,0,51,31,9,4,95,496,UP
UTTAR PRADESH,2004,Retired Person,0,0,2,2,13,17,0,0,0,1,3,4,21,UP
UTTAR PRADESH,2004,Total,85,737,647,355,130,1954,67,922,446,184,64,1683,3637,UP
UTTAR PRADESH,2004,Total Salaried,0,108,114,41,5,268,0,48,43,21,0,112,380,UP
UTTAR PRADESH,2004,Total Self-employed,27,335,356,214,50,982,8,116,69,47,26,266,1248,UP
UTTARAKHAND,2004,Others (Please Specify),7,29,17,5,5,63,2,3,1,2,0,8,71,UK
UTTARAKHAND,2004,House Wife,0,0,0,0,0,0,0,37,18,8,0,63,63,UK
UTTARAKHAND,2004,Service (Government),0,0,5,2,0,7,0,0,0,0,0,0,7,UK
UTTARAKHAND,2004,Service (Private),0,10,6,2,0,18,0,2,1,0,0,3,21,UK
UTTARAKHAND,2004,Public Sector Undertaking,0,0,0,0,0,0,0,0,0,0,0,0,0,UK
UTTARAKHAND,2004,Student,1,6,0,0,0,7,0,9,0,0,0,9,16,UK
UTTARAKHAND,2004,Unemployed,0,10,10,5,1,26,0,1,0,0,0,1,27,UK
UTTARAKHAND,2004,Self-employed (Business activity),0,2,3,3,0,8,0,0,0,0,0,0,8,UK
UTTARAKHAND,2004,Professional Activity,0,0,0,0,0,0,0,0,1,0,0,1,1,UK
UTTARAKHAND,2004,Farming/Agriculture Activity,0,2,11,4,1,18,0,3,1,0,0,4,22,UK
UTTARAKHAND,2004,Retired Person,0,0,1,0,0,1,0,0,0,0,0,0,1,UK
UTTARAKHAND,2004,Total,8,59,53,21,7,148,2,55,22,10,0,89,237,UK
UTTARAKHAND,2004,Total Salaried,0,10,11,4,0,25,0,2,1,0,0,3,28,UK
UTTARAKHAND,2004,Total Self-employed,1,10,22,10,4,47,0,4,2,2,0,8,55,UK
WEST BENGAL,2004,Others (Please Specify),165,949,1059,648,259,3080,142,444,542,352,170,1650,4730,WB
WEST BENGAL,2004,House Wife,0,0,0,0,0,0,0,1577,1224,480,71,3352,3352,WB
WEST BENGAL,2004,Service (Government),0,15,65,45,0,125,0,9,11,6,0,26,151,WB
WEST BENGAL,2004,Service (Private),0,122,263,212,0,597,0,37,20,20,0,77,674,WB
WEST BENGAL,2004,Public Sector Undertaking,0,162,243,246,0,651,0,13,27,26,0,66,717,WB
WEST BENGAL,2004,Student,119,318,11,0,0,448,145,212,4,0,0,361,809,WB
WEST BENGAL,2004,Unemployed,0,371,270,72,0,713,0,68,74,16,0,158,871,WB
WEST BENGAL,2004,Self-employed (Business activity),0,127,271,300,48,746,0,1,20,5,0,26,772,WB
WEST BENGAL,2004,Professional Activity,0,71,70,136,9,286,0,2,4,2,1,9,295,WB
WEST BENGAL,2004,Farming/Agriculture Activity,0,220,298,250,29,797,2,7,10,6,0,25,822,WB
WEST BENGAL,2004,Retired Person,0,0,0,0,218,218,0,0,0,3,10,13,231,WB
WEST BENGAL,2004,Total,284,2355,2550,1909,563,7661,289,2370,1936,916,252,5763,13424,WB
WEST BENGAL,2004,Total Salaried,0,299,571,503,0,1373,0,59,58,52,0,169,1542,WB
WEST BENGAL,2004,Total Self-employed,27,775,1007,942,193,2944,17,170,160,146,86,579,3523,WB
A & N ISLANDS,2005,Others (Please Specify),0,0,4,2,0,6,0,0,0,0,0,0,6,AN
A & N ISLANDS,2005,House Wife,0,0,0,0,0,0,0,11,7,10,4,32,32,AN
A & N ISLANDS,2005,Service (Government),0,1,5,7,0,13,0,0,0,0,0,0,13,AN
A & N ISLANDS,2005,Service (Private),0,9,12,14,12,47,0,4,0,0,0,4,51,AN
A & N ISLANDS,2005,Public Sector Undertaking,0,0,0,0,0,0,0,0,0,0,0,0,0,AN
A & N ISLANDS,2005,Student,2,3,0,0,0,5,3,4,0,0,0,7,12,AN
A & N ISLANDS,2005,Unemployed,0,1,1,1,0,3,0,8,0,0,1,9,12,AN
A & N ISLANDS,2005,Self-employed (Business activity),3,1,0,0,1,5,0,0,0,0,0,0,5,AN
A & N ISLANDS,2005,Professional Activity,0,0,0,0,0,0,0,0,0,0,0,0,0,AN
A & N ISLANDS,2005,Farming/Agriculture Activity,0,0,2,1,4,7,0,0,1,0,0,1,8,AN
A & N ISLANDS,2005,Retired Person,0,0,0,0,0,0,0,0,0,0,0,0,0,AN
A & N ISLANDS,2005,Total,5,15,24,25,17,86,3,27,8,10,5,53,139,AN
A & N ISLANDS,2005,Total Salaried,0,10,17,21,12,60,0,4,0,0,0,4,64,AN
A & N ISLANDS,2005,Total Self-employed,3,1,6,3,5,18,0,0,1,0,0,1,19,AN
ANDHRA PRADESH,2005,Others (Please Specify),79,1055,1462,906,479,3981,73,460,339,214,172,1258,5239,AP
ANDHRA PRADESH,2005,House Wife,0,0,0,0,0,0,0,932,693,382,172,2179,2179,AP
ANDHRA PRADESH,2005,Service (Government),0,10,43,57,0,110,0,6,24,0,0,30,140,AP
ANDHRA PRADESH,2005,Service (Private),2,213,286,161,37,699,0,69,39,18,5,131,830,AP
ANDHRA PRADESH,2005,Public Sector Undertaking,0,42,109,80,2,233,0,5,36,3,0,44,277,AP
ANDHRA PRADESH,2005,Student,53,197,24,0,0,274,65,155,6,0,0,226,500,AP
ANDHRA PRADESH,2005,Unemployed,1,169,160,52,48,430,0,70,10,0,0,80,510,AP
ANDHRA PRADESH,2005,Self-employed (Business activity),2,238,304,244,94,882,0,53,31,27,4,115,997,AP
ANDHRA PRADESH,2005,Professional Activity,0,37,61,43,41,182,1,26,8,3,0,38,220,AP
ANDHRA PRADESH,2005,Farming/Agriculture Activity,6,481,729,578,223,2017,22,127,174,85,65,473,2490,AP
ANDHRA PRADESH,2005,Retired Person,0,2,0,35,20,57,0,1,0,1,1,3,60,AP
ANDHRA PRADESH,2005,Total,143,2444,3178,2156,944,8865,161,1904,1360,733,419,4577,13442,AP
ANDHRA PRADESH,2005,Total Salaried,2,265,438,298,39,1042,0,80,99,21,5,205,1247,AP
ANDHRA PRADESH,2005,Total Self-employed,33,1113,1537,1121,526,4330,46,414,351,185,98,1094,5424,AP
ARUNACHAL PRADESH,2005,Others (Please Specify),0,0,0,0,0,0,0,0,0,0,0,0,0,AR
ARUNACHAL PRADESH,2005,House Wife,0,0,0,0,0,0,0,1,6,1,1,9,9,AR
ARUNACHAL PRADESH,2005,Service (Government),0,0,3,0,0,3,0,1,0,0,0,1,4,AR
ARUNACHAL PRADESH,2005,Service (Private),0,0,4,0,0,4,0,0,1,0,0,1,5,AR
ARUNACHAL PRADESH,2005,Public Sector Undertaking,0,0,0,0,0,0,0,0,0,0,0,0,0,AR
ARUNACHAL PRADESH,2005,Student,0,1,0,0,0,1,0,1,0,0,0,1,2,AR
ARUNACHAL PRADESH,2005,Unemployed,0,1,2,1,0,4,0,1,0,0,0,1,5,AR
ARUNACHAL PRADESH,2005,Self-employed (Business activity),0,5,11,1,1,18,0,1,0,0,0,1,19,AR
ARUNACHAL PRADESH,2005,Professional Activity,0,1,0,0,0,1,0,0,0,0,0,0,1,AR
ARUNACHAL PRADESH,2005,Farming/Agriculture Activity,0,5,8,2,3,18,0,5,2,0,0,7,25,AR
ARUNACHAL PRADESH,2005,Retired Person,0,0,0,0,0,0,0,0,0,0,0,0,0,AR
ARUNACHAL PRADESH,2005,Total,0,13,28,4,4,49,0,10,9,1,1,21,70,AR
ARUNACHAL PRADESH,2005,Total Salaried,0,0,7,0,0,7,0,1,1,0,0,2,9,AR
ARUNACHAL PRADESH,2005,Total Self-employed,0,11,19,3,4,37,0,6,2,0,0,8,45,AR
ASSAM,2005,Others (Please Specify),20,325,398,182,42,967,17,69,54,29,9,178,1145,AS
ASSAM,2005,House Wife,0,0,0,0,0,0,0,281,206,76,3,566,566,AS
ASSAM,2005,Service (Government),0,2,6,6,0,14,0,0,0,0,0,0,14,AS
ASSAM,2005,Service (Private),0,17,17,9,0,43,0,8,2,0,0,10,53,AS
ASSAM,2005,Public Sector Undertaking,0,20,17,19,0,56,0,4,0,0,0,4,60,AS
ASSAM,2005,Student,16,87,0,0,0,103,18,33,0,0,0,51,154,AS
ASSAM,2005,Unemployed,0,5,40,33,9,87,0,0,8,1,0,9,96,AS
ASSAM,2005,Self-employed (Business activity),0,112,164,72,2,350,0,14,13,1,1,29,379,AS
ASSAM,2005,Professional Activity,0,15,32,19,0,66,0,0,0,0,3,3,69,AS
ASSAM,2005,Farming/Agriculture Activity,0,60,117,65,14,256,2,16,16,9,0,43,299,AS
ASSAM,2005,Retired Person,0,0,0,3,6,9,0,0,0,0,2,2,11,AS
ASSAM,2005,Total,36,643,791,408,73,1951,37,425,299,116,18,895,2846,AS
ASSAM,2005,Total Salaried,0,39,40,34,0,113,0,12,2,0,0,14,127,AS
ASSAM,2005,Total Self-employed,11,447,605,275,37,1375,13,76,72,29,9,199,1574,AS
BIHAR,2005,Others (Please Specify),6,55,48,35,8,152,2,34,28,10,2,76,228,BR
BIHAR,2005,House Wife,0,0,0,0,0,0,0,55,38,11,5,109,109,BR
BIHAR,2005,Service (Government),0,0,3,2,0,5,0,1,0,0,0,1,6,BR
BIHAR,2005,Service (Private),0,12,15,7,0,34,0,0,2,0,0,2,36,BR
BIHAR,2005,Public Sector Undertaking,0,1,3,5,0,9,0,0,0,0,0,0,9,BR
BIHAR,2005,Student,7,24,2,0,0,33,3,5,6,0,0,14,47,BR
BIHAR,2005,Unemployed,0,11,5,4,3,23,0,5,0,0,0,5,28,BR
BIHAR,2005,Self-employed (Business activity),0,7,6,4,1,18,0,0,0,0,0,0,18,BR
BIHAR,2005,Professional Activity,0,8,7,4,0,19,0,0,0,0,0,0,19,BR
BIHAR,2005,Farming/Agriculture Activity,1,5,17,8,1,32,0,3,2,2,0,7,39,BR
BIHAR,2005,Retired Person,0,0,0,1,1,2,0,1,1,0,0,2,4,BR
BIHAR,2005,Total,14,123,106,70,14,327,5,104,77,23,7,216,543,BR
BIHAR,2005,Total Salaried,0,13,21,14,0,48,0,1,2,0,0,3,51,BR
BIHAR,2005,Total Self-employed,2,31,39,17,2,91,0,8,4,4,0,16,107,BR
CHANDIGARH,2005,Others (Please Specify),1,5,2,2,0,10,1,3,1,0,0,5,15,CH
CHANDIGARH,2005,House Wife,0,0,0,0,0,0,0,6,5,3,0,14,14,CH
CHANDIGARH,2005,Service (Government),0,1,0,1,0,2,0,0,0,1,0,1,3,CH
CHANDIGARH,2005,Service (Private),0,5,6,6,0,17,0,1,0,0,0,1,18,CH
CHANDIGARH,2005,Public Sector Undertaking,0,0,5,0,0,5,0,0,0,0,0,0,5,CH
CHANDIGARH,2005,Student,1,2,0,0,0,3,0,3,0,0,0,3,6,CH
CHANDIGARH,2005,Unemployed,0,12,3,0,0,15,0,2,0,0,0,2,17,CH
CHANDIGARH,2005,Self-employed (Business activity),0,8,2,1,0,11,0,0,0,0,0,0,11,CH
CHANDIGARH,2005,Professional Activity,0,0,0,0,0,0,0,0,0,0,0,0,0,CH
CHANDIGARH,2005,Farming/Agriculture Activity,0,0,0,0,0,0,0,0,0,0,0,0,0,CH
CHANDIGARH,2005,Retired Person,0,0,0,0,0,0,0,0,0,0,0,0,0,CH
CHANDIGARH,2005,Total,2,33,18,10,0,63,1,15,6,4,0,26,89,CH
CHANDIGARH,2005,Total Salaried,0,6,11,7,0,24,0,1,0,1,0,2,26,CH
CHANDIGARH,2005,Total Self-employed,0,13,4,3,0,20,0,3,1,0,0,4,24,CH
CHHATTISGARH,2005,Others (Please Specify),78,360,441,222,102,1203,37,137,74,33,20,301,1504,CG
CHHATTISGARH,2005,House Wife,0,0,0,0,0,0,8,433,283,115,52,891,891,CG
CHHATTISGARH,2005,Service (Government),0,27,18,12,1,58,0,3,1,1,1,6,64,CG
CHHATTISGARH,2005,Service (Private),14,48,64,44,8,178,2,6,7,2,0,17,195,CG
CHHATTISGARH,2005,Public Sector Undertaking,0,20,11,2,0,33,0,9,3,3,0,15,48,CG
CHHATTISGARH,2005,Student,19,91,6,0,0,116,21,46,5,0,0,72,188,CG
CHHATTISGARH,2005,Unemployed,17,139,50,17,5,228,3,10,7,4,1,25,253,CG
CHHATTISGARH,2005,Self-employed (Business activity),13,36,43,43,12,147,1,13,7,5,1,27,174,CG
CHHATTISGARH,2005,Professional Activity,13,33,50,27,8,131,1,4,2,2,0,9,140,CG
CHHATTISGARH,2005,Farming/Agriculture Activity,6,301,490,309,94,1200,0,81,76,44,11,212,1412,CG
CHHATTISGARH,2005,Retired Person,0,7,1,0,3,11,0,0,0,0,1,1,12,CG
CHHATTISGARH,2005,Total,160,1062,1174,676,233,3305,73,742,465,209,87,1576,4881,CG
CHHATTISGARH,2005,Total Salaried,14,95,93,58,9,269,2,18,11,6,1,38,307,CG
CHHATTISGARH,2005,Total Self-employed,56,453,763,461,155,1888,10,139,127,66,23,365,2253,CG
D & N HAVELI,2005,Others (Please Specify),0,9,5,2,6,22,0,3,0,0,0,3,25,DN
D & N HAVELI,2005,House Wife,0,0,0,0,0,0,0,7,7,7,1,22,22,DN
D & N HAVELI,2005,Service (Government),0,0,0,0,0,0,0,2,1,0,0,3,3,DN
D & N HAVELI,2005,Service (Private),0,3,1,0,0,4,0,0,0,0,0,0,4,DN
D & N HAVELI,2005,Public Sector Undertaking,0,0,0,0,0,0,0,0,0,0,0,0,0,DN
D & N HAVELI,2005,Student,0,0,0,0,0,0,0,0,0,0,0,0,0,DN
D & N HAVELI,2005,Unemployed,0,1,1,0,0,2,0,0,0,0,0,0,2,DN
D & N HAVELI,2005,Self-employed (Business activity),0,0,0,0,0,0,0,0,0,0,0,0,0,DN
D & N HAVELI,2005,Professional Activity,0,0,0,0,0,0,0,0,0,0,0,0,0,DN
D & N HAVELI,2005,Farming/Agriculture Activity,0,3,6,4,0,13,0,0,0,0,0,0,13,DN
D & N HAVELI,2005,Retired Person,0,0,0,0,0,0,0,0,0,0,0,0,0,DN
D & N HAVELI,2005,Total,0,16,13,6,6,41,0,12,8,7,1,28,69,DN
D & N HAVELI,2005,Total Salaried,0,3,1,0,0,4,0,2,1,0,0,3,7,DN
D & N HAVELI,2005,Total Self-employed,0,3,6,4,0,13,0,0,0,0,0,0,13,DN
DAMAN & DIU,2005,Others (Please Specify),0,4,2,4,0,10,0,3,0,0,0,3,13,DD
DAMAN & DIU,2005,House Wife,0,0,0,0,0,0,0,2,2,0,0,4,4,DD
DAMAN & DIU,2005,Service (Government),0,0,0,0,0,0,0,0,0,0,0,0,0,DD
DAMAN & DIU,2005,Service (Private),0,6,1,1,0,8,0,0,0,0,0,0,8,DD
DAMAN & DIU,2005,Public Sector Undertaking,0,0,0,1,0,1,0,0,0,0,0,0,1,DD
DAMAN & DIU,2005,Student,1,0,0,0,0,1,0,0,0,0,0,0,1,DD
DAMAN & DIU,2005,Unemployed,0,0,0,4,0,4,0,0,0,0,0,0,4,DD
DAMAN & DIU,2005,Self-employed (Business activity),0,0,1,0,0,1,0,0,0,0,0,0,1,DD
DAMAN & DIU,2005,Professional Activity,0,0,0,0,0,0,0,0,0,0,0,0,0,DD
DAMAN & DIU,2005,Farming/Agriculture Activity,0,0,0,0,0,0,0,0,0,0,0,0,0,DD
DAMAN & DIU,2005,Retired Person,0,0,0,0,0,0,0,0,0,0,0,0,0,DD
DAMAN & DIU,2005,Total,1,10,4,10,0,25,0,5,2,0,0,7,32,DD
DAMAN & DIU,2005,Total Salaried,0,6,1,2,0,9,0,0,0,0,0,0,9,DD
DAMAN & DIU,2005,Total Self-employed,0,3,2,4,0,9,0,0,0,0,0,0,9,DD
DELHI (UT),2005,Others (Please Specify),3,119,98,42,11,273,5,42,29,2,1,79,352,DL
DELHI (UT),2005,House Wife,0,0,0,0,0,0,0,162,102,23,7,294,294,DL
DELHI (UT),2005,Service (Government),0,7,18,11,0,36,0,3,0,1,0,4,40,DL
DELHI (UT),2005,Service (Private),0,76,58,29,2,165,1,14,3,0,0,18,183,DL
DELHI (UT),2005,Public Sector Undertaking,0,1,2,1,0,4,0,1,0,0,0,1,5,DL
DELHI (UT),2005,Student,4,50,5,0,0,59,5,33,1,0,0,39,98,DL
DELHI (UT),2005,Unemployed,1,109,69,24,6,209,2,25,5,0,0,32,241,DL
DELHI (UT),2005,Self-employed (Business activity),0,7,8,0,1,16,0,0,0,0,0,0,16,DL
DELHI (UT),2005,Professional Activity,0,0,1,3,1,5,0,1,0,0,0,1,6,DL
DELHI (UT),2005,Farming/Agriculture Activity,0,1,5,1,0,7,0,0,0,0,0,0,7,DL
DELHI (UT),2005,Retired Person,0,0,0,0,3,3,0,0,0,0,0,0,3,DL
DELHI (UT),2005,Total,8,370,264,111,24,777,13,281,140,26,8,468,1245,DL
DELHI (UT),2005,Total Salaried,0,84,78,41,2,205,1,18,3,1,0,23,228,DL
DELHI (UT),2005,Total Self-employed,0,62,58,21,9,150,0,12,12,1,0,25,175,DL
GOA,2005,Others (Please Specify),0,13,30,13,6,62,1,4,3,1,0,9,71,GA
GOA,2005,House Wife,0,0,0,0,0,0,0,18,8,13,8,47,47,GA
GOA,2005,Service (Government),0,2,3,2,0,7,0,0,0,0,0,0,7,GA
GOA,2005,Service (Private),0,13,25,8,0,46,0,4,2,0,0,6,52,GA
GOA,2005,Public Sector Undertaking,0,2,3,1,0,6,0,0,0,0,0,0,6,GA
GOA,2005,Student,2,6,0,0,0,8,1,6,0,0,0,7,15,GA
GOA,2005,Unemployed,0,15,17,8,5,45,0,10,1,1,1,13,58,GA
GOA,2005,Self-employed (Business activity),0,2,3,3,0,8,0,0,1,0,0,1,9,GA
GOA,2005,Professional Activity,0,1,0,0,0,1,0,0,0,0,0,0,1,GA
GOA,2005,Farming/Agriculture Activity,0,0,4,2,4,10,0,0,0,0,1,1,11,GA
GOA,2005,Retired Person,0,0,0,3,1,4,0,0,0,0,1,1,5,GA
GOA,2005,Total,2,54,85,40,16,197,2,42,15,15,11,85,282,GA
GOA,2005,Total Salaried,0,17,31,11,0,59,0,4,2,0,0,6,65,GA
GOA,2005,Total Self-employed,0,5,14,7,6,32,0,0,2,0,1,3,35,GA
GUJARAT,2005,Others (Please Specify),8,210,270,120,39,647,9,87,42,25,18,181,828,GJ
GUJARAT,2005,House Wife,0,0,0,0,0,0,0,548,498,203,71,1320,1320,GJ
GUJARAT,2005,Service (Government),0,21,35,17,0,73,0,1,1,2,0,4,77,GJ
GUJARAT,2005,Service (Private),0,135,191,97,5,428,0,32,19,5,0,56,484,GJ
GUJARAT,2005,Public Sector Undertaking,0,18,33,16,0,67,0,2,1,0,0,3,70,GJ
GUJARAT,2005,Student,16,82,7,0,0,105,21,99,0,0,0,120,225,GJ
GUJARAT,2005,Unemployed,1,151,140,75,5,372,1,26,8,3,2,40,412,GJ
GUJARAT,2005,Self-employed (Business activity),0,84,108,59,16,267,0,1,0,0,1,2,269,GJ
GUJARAT,2005,Professional Activity,0,120,115,68,17,320,0,10,3,0,0,13,333,GJ
GUJARAT,2005,Farming/Agriculture Activity,0,159,182,136,42,519,2,45,29,16,4,96,615,GJ
GUJARAT,2005,Retired Person,0,0,1,35,68,104,0,0,0,5,23,28,132,GJ
GUJARAT,2005,Total,25,980,1082,623,192,2902,33,851,601,259,119,1863,4765,GJ
GUJARAT,2005,Total Salaried,0,174,259,130,5,568,0,35,21,7,0,63,631,GJ
GUJARAT,2005,Total Self-employed,3,502,578,330,85,1498,4,90,50,25,10,179,1677,GJ
HARYANA,2005,Others (Please Specify),15,246,365,183,47,856,3,90,41,21,8,163,1019,HR
HARYANA,2005,House Wife,0,0,0,0,0,0,2,119,125,49,8,303,303,HR
HARYANA,2005,Service (Government),0,14,16,7,0,37,0,1,5,0,0,6,43,HR
HARYANA,2005,Service (Private),0,72,48,24,0,144,1,6,3,1,0,11,155,HR
HARYANA,2005,Public Sector Undertaking,0,4,10,1,0,15,0,3,2,0,0,5,20,HR
HARYANA,2005,Student,7,57,3,0,0,67,6,25,3,0,0,34,101,HR
HARYANA,2005,Unemployed,5,64,54,17,6,146,0,7,4,1,1,13,159,HR
HARYANA,2005,Self-employed (Business activity),0,10,38,15,8,71,0,0,0,0,0,0,71,HR
HARYANA,2005,Professional Activity,0,6,11,0,1,18,1,0,0,0,0,1,19,HR
HARYANA,2005,Farming/Agriculture Activity,1,37,57,23,10,128,2,6,2,2,0,12,140,HR
HARYANA,2005,Retired Person,0,0,6,4,1,11,0,0,2,2,1,5,16,HR
HARYANA,2005,Total,28,510,608,274,73,1493,15,257,187,76,18,553,2046,HR
HARYANA,2005,Total Salaried,0,90,74,32,0,196,1,10,10,1,0,22,218,HR
HARYANA,2005,Total Self-employed,6,136,174,72,31,419,5,17,5,5,0,32,451,HR
HIMACHAL PRADESH,2005,Others (Please Specify),2,28,39,23,12,104,0,19,17,5,3,44,148,HP
HIMACHAL PRADESH,2005,House Wife,0,0,0,0,0,0,0,41,26,8,0,75,75,HP
HIMACHAL PRADESH,2005,Service (Government),0,1,9,4,0,14,0,1,1,0,0,2,16,HP
HIMACHAL PRADESH,2005,Service (Private),0,10,14,4,1,29,0,0,0,0,0,0,29,HP
HIMACHAL PRADESH,2005,Public Sector Undertaking,0,1,5,1,0,7,0,1,0,0,0,1,8,HP
HIMACHAL PRADESH,2005,Student,0,9,1,0,0,10,1,14,0,0,0,15,25,HP
HIMACHAL PRADESH,2005,Unemployed,0,9,9,1,0,19,0,5,3,0,0,8,27,HP
HIMACHAL PRADESH,2005,Self-employed (Business activity),0,2,3,2,0,7,0,0,0,0,0,0,7,HP
HIMACHAL PRADESH,2005,Professional Activity,0,1,3,0,0,4,0,0,0,0,0,0,4,HP
HIMACHAL PRADESH,2005,Farming/Agriculture Activity,0,8,3,7,2,20,0,0,0,0,0,0,20,HP
HIMACHAL PRADESH,2005,Retired Person,0,0,0,0,0,0,0,0,0,0,0,0,0,HP
HIMACHAL PRADESH,2005,Total,2,69,86,42,15,214,1,81,47,13,3,145,359,HP
HIMACHAL PRADESH,2005,Total Salaried,0,12,28,9,1,50,0,2,1,0,0,3,53,HP
HIMACHAL PRADESH,2005,Total Self-employed,0,23,33,25,14,95,0,4,6,4,1,15,110,HP
JAMMU & KASHMIR,2005,Others (Please Specify),2,37,31,15,4,89,3,30,12,0,3,48,137,JK
JAMMU & KASHMIR,2005,House Wife,0,0,0,0,0,0,0,17,14,1,0,32,32,JK
JAMMU & KASHMIR,2005,Service (Government),0,14,4,0,0,18,0,0,0,0,0,0,18,JK
JAMMU & KASHMIR,2005,Service (Private),0,23,11,0,0,34,0,0,0,0,0,0,34,JK
JAMMU & KASHMIR,2005,Public Sector Undertaking,0,0,0,0,0,0,0,0,0,0,0,0,0,JK
JAMMU & KASHMIR,2005,Student,1,14,5,0,0,20,1,3,0,0,0,4,24,JK
JAMMU & KASHMIR,2005,Unemployed,0,18,8,1,0,27,0,3,10,0,0,13,40,JK
JAMMU & KASHMIR,2005,Self-employed (Business activity),0,0,0,0,0,0,0,0,0,0,0,0,0,JK
JAMMU & KASHMIR,2005,Professional Activity,0,0,0,0,0,0,0,0,0,0,0,0,0,JK
JAMMU & KASHMIR,2005,Farming/Agriculture Activity,0,1,0,0,0,1,0,1,0,0,0,1,2,JK
JAMMU & KASHMIR,2005,Retired Person,0,6,0,1,0,7,0,0,0,0,0,0,7,JK
JAMMU & KASHMIR,2005,Total,3,113,59,17,4,196,4,54,36,1,3,98,294,JK
JAMMU & KASHMIR,2005,Total Salaried,0,37,15,0,0,52,0,0,0,0,0,0,52,JK
JAMMU & KASHMIR,2005,Total Self-employed,0,20,9,5,0,34,0,18,9,0,2,29,63,JK
JHARKHAND,2005,Others (Please Specify),6,49,73,74,10,212,7,31,19,5,1,63,275,JH
JHARKHAND,2005,House Wife,0,0,0,0,0,0,0,57,76,22,3,158,158,JH
JHARKHAND,2005,Service (Government),0,0,4,5,0,9,0,1,1,0,0,2,11,JH
JHARKHAND,2005,Service (Private),0,14,13,6,0,33,0,0,9,0,0,9,42,JH
JHARKHAND,2005,Public Sector Undertaking,0,2,3,0,0,5,0,1,0,0,0,1,6,JH
JHARKHAND,2005,Student,2,53,14,0,0,69,6,14,9,0,0,29,98,JH
JHARKHAND,2005,Unemployed,0,20,6,0,0,26,0,8,14,0,0,22,48,JH
JHARKHAND,2005,Self-employed (Business activity),0,5,14,14,0,33,0,0,0,1,0,1,34,JH
JHARKHAND,2005,Professional Activity,0,0,4,5,0,9,0,0,0,0,0,0,9,JH
JHARKHAND,2005,Farming/Agriculture Activity,0,38,56,29,1,124,0,0,0,0,0,0,124,JH
JHARKHAND,2005,Retired Person,0,0,0,0,3,3,0,0,0,0,0,0,3,JH
JHARKHAND,2005,Total,8,181,187,133,14,523,13,112,128,28,4,285,808,JH
JHARKHAND,2005,Total Salaried,0,16,20,11,0,47,0,2,10,0,0,12,59,JH
JHARKHAND,2005,Total Self-employed,2,64,98,56,1,221,5,16,9,5,1,36,257,JH
KARNATAKA,2005,Others (Please Specify),59,973,1206,925,398,3561,48,484,363,225,125,1245,4806,KA
KARNATAKA,2005,House Wife,0,0,0,0,0,0,4,816,658,280,116,1874,1874,KA
KARNATAKA,2005,Service (Government),0,32,41,66,0,139,0,9,7,5,0,21,160,KA
KARNATAKA,2005,Service (Private),1,342,295,235,16,889,1,54,35,24,10,124,1013,KA
KARNATAKA,2005,Public Sector Undertaking,0,57,60,56,11,184,0,11,13,10,0,34,218,KA
KARNATAKA,2005,Student,35,137,15,2,0,189,32,134,13,0,0,179,368,KA
KARNATAKA,2005,Unemployed,3,192,117,68,23,403,0,34,20,8,4,66,469,KA
KARNATAKA,2005,Self-employed (Business activity),1,118,168,101,14,402,0,9,23,14,0,46,448,KA
KARNATAKA,2005,Professional Activity,1,59,96,69,17,242,2,3,3,21,7,36,278,KA
KARNATAKA,2005,Farming/Agriculture Activity,4,350,691,422,196,1663,0,58,91,61,10,220,1883,KA
KARNATAKA,2005,Retired Person,0,1,2,8,24,35,0,2,0,3,0,5,40,KA
KARNATAKA,2005,Total,104,2261,2691,1952,699,7707,87,1614,1226,651,272,3850,11557,KA
KARNATAKA,2005,Total Salaried,1,431,396,357,27,1212,1,74,55,39,10,179,1391,KA
KARNATAKA,2005,Total Self-employed,18,1038,1560,1032,441,4089,8,278,243,190,74,793,4882,KA
KERALA,2005,Others (Please Specify),6,661,1036,1204,706,3613,8,124,109,113,115,469,4082,KL
KERALA,2005,House Wife,0,0,0,0,0,0,0,305,421,390,297,1413,1413,KL
KERALA,2005,Service (Government),0,1,30,36,0,67,0,4,6,8,0,18,85,KL
KERALA,2005,Service (Private),0,45,131,82,15,273,0,24,14,9,2,49,322,KL
KERALA,2005,Public Sector Undertaking,0,6,17,23,0,46,0,6,1,3,0,10,56,KL
KERALA,2005,Student,40,100,0,0,0,140,40,100,1,0,0,141,281,KL
KERALA,2005,Unemployed,0,268,355,228,129,980,1,114,58,33,35,241,1221,KL
KERALA,2005,Self-employed (Business activity),0,37,148,172,38,395,0,3,1,1,0,5,400,KL
KERALA,2005,Professional Activity,0,31,65,48,7,151,0,7,3,1,0,11,162,KL
KERALA,2005,Farming/Agriculture Activity,0,89,337,383,264,1073,1,3,17,17,7,45,1118,KL
KERALA,2005,Retired Person,0,0,0,31,61,92,0,0,1,1,10,12,104,KL
KERALA,2005,Total,46,1238,2119,2207,1220,6830,50,690,632,576,466,2414,9244,KL
KERALA,2005,Total Salaried,0,52,178,141,15,386,0,34,21,20,2,77,463,KL
KERALA,2005,Total Self-employed,1,610,1249,1418,778,4056,3,90,96,105,79,373,4429,KL
LAKSHADWEEP,2005,Others (Please Specify),0,0,0,0,0,0,0,0,0,0,0,0,0,LD
LAKSHADWEEP,2005,House Wife,0,0,0,0,0,0,0,0,0,0,0,0,0,LD
LAKSHADWEEP,2005,Service (Government),0,0,0,0,0,0,0,0,0,0,0,0,0,LD
LAKSHADWEEP,2005,Service (Private),0,0,0,0,0,0,0,0,0,0,0,0,0,LD
LAKSHADWEEP,2005,Public Sector Undertaking,0,0,0,0,0,0,0,0,0,0,0,0,0,LD
LAKSHADWEEP,2005,Student,0,0,0,0,0,0,0,0,0,0,0,0,0,LD
LAKSHADWEEP,2005,Unemployed,0,0,0,0,0,0,0,0,0,0,0,0,0,LD
LAKSHADWEEP,2005,Self-employed (Business activity),0,0,0,0,0,0,0,0,0,0,0,0,0,LD
LAKSHADWEEP,2005,Professional Activity,0,0,0,0,0,0,0,0,0,0,0,0,0,LD
LAKSHADWEEP,2005,Farming/Agriculture Activity,0,0,0,0,0,0,0,0,0,0,0,0,0,LD
LAKSHADWEEP,2005,Retired Person,0,0,0,0,0,0,0,0,0,0,0,0,0,LD
LAKSHADWEEP,2005,Total,0,0,0,0,0,0,0,0,0,0,0,0,0,LD
LAKSHADWEEP,2005,Total Salaried,0,0,0,0,0,0,0,0,0,0,0,0,0,LD
LAKSHADWEEP,2005,Total Self-employed,0,0,0,0,0,0,0,0,0,0,0,0,0,LD
MADHYA PRADESH,2005,Others (Please Specify),37,255,294,152,100,838,56,140,57,10,10,273,1111,MP
MADHYA PRADESH,2005,House Wife,0,0,0,0,0,0,0,1114,523,178,77,1892,1892,MP
MADHYA PRADESH,2005,Service (Government),0,7,19,17,0,43,0,6,4,1,0,11,54,MP
MADHYA PRADESH,2005,Service (Private),0,73,64,26,5,168,0,40,5,1,1,47,215,MP
MADHYA PRADESH,2005,Public Sector Undertaking,0,44,33,10,5,92,0,16,14,1,0,31,123,MP
MADHYA PRADESH,2005,Student,34,95,1,0,0,130,18,51,0,0,0,69,199,MP
MADHYA PRADESH,2005,Unemployed,0,108,62,36,6,212,0,17,8,2,0,27,239,MP
MADHYA PRADESH,2005,Self-employed (Business activity),3,60,66,35,10,174,0,18,5,1,0,24,198,MP
MADHYA PRADESH,2005,Professional Activity,2,30,77,19,3,131,0,17,4,6,3,30,161,MP
MADHYA PRADESH,2005,Farming/Agriculture Activity,7,452,333,177,86,1055,4,108,64,12,5,193,1248,MP
MADHYA PRADESH,2005,Retired Person,0,0,0,0,8,8,0,0,0,0,0,0,8,MP
MADHYA PRADESH,2005,Total,83,1124,949,472,223,2851,78,1527,684,212,96,2597,5448,MP
MADHYA PRADESH,2005,Total Salaried,0,124,116,53,10,303,0,62,23,3,1,89,392,MP
MADHYA PRADESH,2005,Total Self-employed,27,735,712,335,167,1976,30,239,109,28,17,423,2399,MP
MAHARASHTRA,2005,Others (Please Specify),18,529,677,399,265,1888,18,123,65,62,21,289,2177,MH
MAHARASHTRA,2005,House Wife,0,0,0,0,0,0,3,1857,1084,409,229,3582,3582,MH
MAHARASHTRA,2005,Service (Government),0,36,122,102,0,260,0,18,18,4,0,40,300,MH
MAHARASHTRA,2005,Service (Private),0,456,650,340,39,1485,1,78,34,6,2,121,1606,MH
MAHARASHTRA,2005,Public Sector Undertaking,0,30,39,33,3,105,0,9,3,1,0,13,118,MH
MAHARASHTRA,2005,Student,53,346,3,0,0,402,55,327,0,0,0,382,784,MH
MAHARASHTRA,2005,Unemployed,0,459,368,121,2,950,0,63,13,3,0,79,1029,MH
MAHARASHTRA,2005,Self-employed (Business activity),0,98,188,81,17,384,0,4,1,1,0,6,390,MH
MAHARASHTRA,2005,Professional Activity,0,97,151,102,27,377,0,7,2,4,3,16,393,MH
MAHARASHTRA,2005,Farming/Agriculture Activity,4,826,1433,908,467,3638,2,127,76,58,25,288,3926,MH
MAHARASHTRA,2005,Retired Person,0,0,0,15,99,114,0,0,0,1,6,7,121,MH
MAHARASHTRA,2005,Total,75,2877,3631,2101,919,9603,79,2613,1296,549,286,4823,14426,MH
MAHARASHTRA,2005,Total Salaried,0,522,811,475,42,1850,1,105,55,11,2,174,2024,MH
MAHARASHTRA,2005,Total Self-employed,21,1522,2397,1464,762,6166,17,255,136,122,47,577,6743,MH
MANIPUR,2005,Others (Please Specify),0,2,6,0,0,8,0,1,0,0,0,1,9,MN
MANIPUR,2005,House Wife,0,0,0,0,0,0,0,0,2,0,0,2,2,MN
MANIPUR,2005,Service (Government),0,1,7,0,0,8,0,0,0,0,0,0,8,MN
MANIPUR,2005,Service (Private),0,0,0,0,0,0,0,0,0,0,0,0,0,MN
MANIPUR,2005,Public Sector Undertaking,0,0,0,0,0,0,0,0,0,0,0,0,0,MN
MANIPUR,2005,Student,0,1,0,0,0,1,0,1,0,0,0,1,2,MN
MANIPUR,2005,Unemployed,0,0,0,0,0,0,0,0,0,0,0,0,0,MN
MANIPUR,2005,Self-employed (Business activity),0,1,2,1,0,4,0,0,0,0,0,0,4,MN
MANIPUR,2005,Professional Activity,0,0,0,0,0,0,0,0,0,0,0,0,0,MN
MANIPUR,2005,Farming/Agriculture Activity,0,0,2,0,0,2,0,0,0,0,0,0,2,MN
MANIPUR,2005,Retired Person,0,0,0,0,0,0,0,0,0,0,0,0,0,MN
MANIPUR,2005,Total,0,5,17,1,0,23,0,2,2,0,0,4,27,MN
MANIPUR,2005,Total Salaried,0,1,7,0,0,8,0,0,0,0,0,0,8,MN
MANIPUR,2005,Total Self-employed,0,2,9,1,0,12,0,0,0,0,0,0,12,MN
MEGHALAYA,2005,Others (Please Specify),0,3,3,5,1,12,0,0,0,0,1,1,13,ML
MEGHALAYA,2005,House Wife,0,0,0,0,0,0,0,6,3,2,0,11,11,ML
MEGHALAYA,2005,Service (Government),0,0,1,0,0,1,0,0,0,0,0,0,1,ML
MEGHALAYA,2005,Service (Private),0,0,2,1,0,3,0,0,0,0,0,0,3,ML
MEGHALAYA,2005,Public Sector Undertaking,0,0,0,1,0,1,0,0,0,0,0,0,1,ML
MEGHALAYA,2005,Student,2,4,0,0,0,6,0,5,0,0,0,5,11,ML
MEGHALAYA,2005,Unemployed,1,6,5,2,1,15,0,2,2,0,0,4,19,ML
MEGHALAYA,2005,Self-employed (Business activity),0,2,1,0,0,3,0,0,0,0,0,0,3,ML
MEGHALAYA,2005,Professional Activity,0,0,0,0,0,0,0,0,0,0,0,0,0,ML
MEGHALAYA,2005,Farming/Agriculture Activity,0,1,2,0,1,4,0,0,0,0,0,0,4,ML
MEGHALAYA,2005,Retired Person,0,0,0,1,4,5,0,0,0,0,0,0,5,ML
MEGHALAYA,2005,Total,3,16,14,10,7,50,0,13,5,2,1,21,71,ML
MEGHALAYA,2005,Total Salaried,0,0,3,2,0,5,0,0,0,0,0,0,5,ML
MEGHALAYA,2005,Total Self-employed,0,4,6,5,2,17,0,0,0,0,0,0,17,ML
MIZORAM,2005,Others (Please Specify),2,10,11,4,2,29,0,2,1,0,0,3,32,MZ
MIZORAM,2005,House Wife,0,0,0,0,0,0,0,0,2,1,0,3,3,MZ
MIZORAM,2005,Service (Government),0,1,3,0,0,4,0,0,0,0,0,0,4,MZ
MIZORAM,2005,Service (Private),0,0,1,0,0,1,0,0,0,0,0,0,1,MZ
MIZORAM,2005,Public Sector Undertaking,0,0,0,0,0,0,0,0,0,0,0,0,0,MZ
MIZORAM,2005,Student,0,0,0,0,0,0,0,0,0,0,0,0,0,MZ
MIZORAM,2005,Unemployed,0,8,5,0,0,13,0,1,1,0,0,2,15,MZ
MIZORAM,2005,Self-employed (Business activity),0,0,0,0,0,0,0,0,0,0,0,0,0,MZ
MIZORAM,2005,Professional Activity,0,0,0,0,0,0,0,0,0,0,0,0,0,MZ
MIZORAM,2005,Farming/Agriculture Activity,0,0,0,0,0,0,0,0,0,0,0,0,0,MZ
MIZORAM,2005,Retired Person,0,0,0,0,0,0,0,0,0,0,0,0,0,MZ
MIZORAM,2005,Total,2,19,20,4,2,47,0,3,4,1,0,8,55,MZ
MIZORAM,2005,Total Salaried,0,1,4,0,0,5,0,0,0,0,0,0,5,MZ
MIZORAM,2005,Total Self-employed,0,0,3,0,0,3,0,0,1,0,0,1,4,MZ
NAGALAND,2005,Others (Please Specify),0,1,3,2,0,6,0,1,1,0,0,2,8,NG
NAGALAND,2005,House Wife,0,0,0,0,0,0,0,0,1,0,0,1,1,NG
NAGALAND,2005,Service (Government),0,0,7,2,0,9,0,0,1,0,0,1,10,NG
NAGALAND,2005,Service (Private),0,0,0,0,0,0,0,0,0,0,0,0,0,NG
NAGALAND,2005,Public Sector Undertaking,0,0,0,0,0,0,0,0,0,0,0,0,0,NG
NAGALAND,2005,Student,0,3,0,0,0,3,0,2,0,0,0,2,5,NG
NAGALAND,2005,Unemployed,0,0,1,0,0,1,0,0,0,0,0,0,1,NG
NAGALAND,2005,Self-employed (Business activity),0,0,1,0,0,1,0,0,0,0,0,0,1,NG
NAGALAND,2005,Professional Activity,0,0,1,0,0,1,0,0,0,0,0,0,1,NG
NAGALAND,2005,Farming/Agriculture Activity,0,0,0,0,0,0,0,0,0,0,0,0,0,NG
NAGALAND,2005,Retired Person,0,0,0,0,0,0,0,0,0,0,0,0,0,NG
NAGALAND,2005,Total,0,4,13,4,0,21,0,3,3,0,0,6,27,NG
NAGALAND,2005,Total Salaried,0,0,7,2,0,9,0,0,1,0,0,1,10,NG
NAGALAND,2005,Total Self-employed,0,1,5,2,0,8,0,1,1,0,0,2,10,NG
ODISHA,2005,Others (Please Specify),30,322,408,349,173,1282,32,222,187,103,44,588,1870,OD
ODISHA,2005,House Wife,0,0,0,0,0,0,0,247,237,89,14,587,587,OD
ODISHA,2005,Service (Government),0,16,26,12,0,54,0,7,18,1,0,26,80,OD
ODISHA,2005,Service (Private),0,31,25,31,1,88,0,33,32,20,3,88,176,OD
ODISHA,2005,Public Sector Undertaking,0,29,34,25,1,89,0,7,8,8,0,23,112,OD
ODISHA,2005,Student,28,111,10,0,0,149,26,85,2,0,0,113,262,OD
ODISHA,2005,Unemployed,0,101,136,35,6,278,2,44,49,9,6,110,388,OD
ODISHA,2005,Self-employed (Business activity),0,59,167,73,21,320,0,20,9,11,2,42,362,OD
ODISHA,2005,Professional Activity,0,19,27,32,2,80,0,8,8,7,2,25,105,OD
ODISHA,2005,Farming/Agriculture Activity,0,38,86,61,19,204,0,13,22,15,0,50,254,OD
ODISHA,2005,Retired Person,0,0,0,0,10,10,0,0,0,0,2,2,12,OD
ODISHA,2005,Total,58,726,919,618,233,2554,60,686,572,263,73,1654,4208,OD
ODISHA,2005,Total Salaried,0,76,85,68,2,231,0,47,58,29,3,137,368,OD
ODISHA,2005,Total Self-employed,26,298,563,413,196,1496,13,181,146,102,39,481,1977,OD
PUDUCHERRY,2005,Others (Please Specify),0,0,2,4,1,7,0,0,0,0,0,0,7,PY
PUDUCHERRY,2005,House Wife,0,0,0,0,0,0,0,48,51,18,9,126,126,PY
PUDUCHERRY,2005,Service (Government),0,1,5,6,0,12,0,0,0,1,0,1,13,PY
PUDUCHERRY,2005,Service (Private),0,16,33,25,1,75,0,10,1,0,0,11,86,PY
PUDUCHERRY,2005,Public Sector Undertaking,0,0,1,0,1,2,0,0,0,0,0,0,2,PY
PUDUCHERRY,2005,Student,1,5,1,0,0,7,2,14,0,0,0,16,23,PY
PUDUCHERRY,2005,Unemployed,0,22,12,21,16,71,0,28,2,0,11,41,112,PY
PUDUCHERRY,2005,Self-employed (Business activity),0,2,5,1,2,10,0,0,0,0,0,0,10,PY
PUDUCHERRY,2005,Professional Activity,0,1,5,2,0,8,0,0,0,0,0,0,8,PY
PUDUCHERRY,2005,Farming/Agriculture Activity,0,28,65,45,6,144,0,1,2,0,0,3,147,PY
PUDUCHERRY,2005,Retired Person,0,0,0,1,3,4,0,0,0,0,0,0,4,PY
PUDUCHERRY,2005,Total,1,75,129,105,30,340,2,101,56,19,20,198,538,PY
PUDUCHERRY,2005,Total Salaried,0,17,39,31,2,89,0,10,1,1,0,12,101,PY
PUDUCHERRY,2005,Total Self-employed,0,31,75,48,8,162,0,1,2,0,0,3,165,PY
PUNJAB,2005,Others (Please Specify),0,60,102,55,22,239,1,1,7,4,1,14,253,PN
PUNJAB,2005,House Wife,0,0,0,0,0,0,0,33,28,15,1,77,77,PN
PUNJAB,2005,Service (Government),0,2,6,6,1,15,0,1,0,0,0,1,16,PN
PUNJAB,2005,Service (Private),0,19,16,0,0,35,0,0,0,0,0,0,35,PN
PUNJAB,2005,Public Sector Undertaking,0,0,2,0,0,2,0,0,0,0,0,0,2,PN
PUNJAB,2005,Student,0,16,0,1,0,17,0,4,0,0,0,4,21,PN
PUNJAB,2005,Unemployed,0,25,13,8,1,47,1,1,3,0,0,5,52,PN
PUNJAB,2005,Self-employed (Business activity),0,14,24,17,3,58,0,2,2,1,0,5,63,PN
PUNJAB,2005,Professional Activity,0,4,4,5,1,14,0,0,0,0,0,0,14,PN
PUNJAB,2005,Farming/Agriculture Activity,0,24,0,17,6,47,0,0,0,0,0,0,47,PN
PUNJAB,2005,Retired Person,0,0,0,3,5,8,0,0,0,0,0,0,8,PN
PUNJAB,2005,Total,0,164,167,112,39,482,2,42,40,20,2,106,588,PN
PUNJAB,2005,Total Salaried,0,21,24,6,1,52,0,1,0,0,0,1,53,PN
PUNJAB,2005,Total Self-employed,0,97,83,67,20,267,0,3,4,1,0,8,275,PN
RAJASTHAN,2005,Others (Please Specify),55,491,684,407,116,1753,24,75,34,6,2,141,1894,RJ
RAJASTHAN,2005,House Wife,0,0,0,0,0,0,13,459,408,201,19,1100,1100,RJ
RAJASTHAN,2005,Service (Government),0,9,19,10,0,38,0,0,0,0,0,0,38,RJ
RAJASTHAN,2005,Service (Private),0,108,107,58,2,275,0,8,3,0,0,11,286,RJ
RAJASTHAN,2005,Public Sector Undertaking,0,15,9,6,0,30,0,2,2,0,0,4,34,RJ
RAJASTHAN,2005,Student,19,56,0,0,0,75,13,22,2,0,0,37,112,RJ
RAJASTHAN,2005,Unemployed,3,57,32,6,2,100,0,2,0,0,0,2,102,RJ
RAJASTHAN,2005,Self-employed (Business activity),0,46,51,20,3,120,0,0,0,0,0,0,120,RJ
RAJASTHAN,2005,Professional Activity,0,12,13,2,0,27,0,0,0,0,0,0,27,RJ
RAJASTHAN,2005,Farming/Agriculture Activity,11,138,210,65,12,436,0,6,14,5,0,25,461,RJ
RAJASTHAN,2005,Retired Person,0,0,0,2,2,4,0,0,0,0,0,0,4,RJ
RAJASTHAN,2005,Total,88,932,1125,576,137,2858,50,574,463,212,21,1320,4178,RJ
RAJASTHAN,2005,Total Salaried,0,132,135,74,2,343,0,10,5,0,0,15,358,RJ
RAJASTHAN,2005,Total Self-employed,28,395,489,177,32,1121,6,34,24,9,1,74,1195,RJ
SIKKIM,2005,Others (Please Specify),0,5,5,5,0,15,0,0,5,3,3,11,26,SK
SIKKIM,2005,House Wife,0,0,0,0,0,0,0,10,7,1,2,20,20,SK
SIKKIM,2005,Service (Government),0,0,2,0,0,2,0,0,0,0,0,0,2,SK
SIKKIM,2005,Service (Private),0,2,0,0,0,2,0,0,3,0,0,3,5,SK
SIKKIM,2005,Public Sector Undertaking,0,0,0,0,0,0,0,0,0,0,0,0,0,SK
SIKKIM,2005,Student,2,2,1,0,0,5,2,3,0,0,0,5,10,SK
SIKKIM,2005,Unemployed,0,2,2,0,0,4,0,0,0,0,0,0,4,SK
SIKKIM,2005,Self-employed (Business activity),0,0,0,0,0,0,0,0,1,0,0,1,1,SK
SIKKIM,2005,Professional Activity,0,0,0,0,0,0,0,0,0,0,0,0,0,SK
SIKKIM,2005,Farming/Agriculture Activity,0,15,7,8,4,34,0,1,3,3,0,7,41,SK
SIKKIM,2005,Retired Person,0,0,0,0,0,0,0,0,0,0,0,0,0,SK
SIKKIM,2005,Total,2,26,17,13,4,62,2,14,19,7,5,47,109,SK
SIKKIM,2005,Total Salaried,0,2,2,0,0,4,0,0,3,0,0,3,7,SK
SIKKIM,2005,Total Self-employed,0,18,12,11,4,45,0,1,6,4,3,14,59,SK
TAMIL NADU,2005,Others (Please Specify),56,577,995,714,284,2626,100,337,227,205,79,948,3574,TN
TAMIL NADU,2005,House Wife,0,0,0,0,0,0,0,647,737,493,181,2058,2058,TN
TAMIL NADU,2005,Service (Government),0,35,63,58,3,159,0,5,16,11,0,32,191,TN
TAMIL NADU,2005,Service (Private),0,259,357,280,51,947,3,115,93,33,5,249,1196,TN
TAMIL NADU,2005,Public Sector Undertaking,0,48,88,59,10,205,0,14,30,23,8,75,280,TN
TAMIL NADU,2005,Student,73,173,15,0,0,261,59,203,7,1,0,270,531,TN
TAMIL NADU,2005,Unemployed,7,390,426,267,84,1174,5,249,141,76,40,511,1685,TN
TAMIL NADU,2005,Self-employed (Business activity),0,195,301,243,54,793,0,42,28,37,18,125,918,TN
TAMIL NADU,2005,Professional Activity,0,72,93,73,8,246,0,21,13,4,2,40,286,TN
TAMIL NADU,2005,Farming/Agriculture Activity,11,217,369,263,142,1002,5,102,73,40,33,253,1255,TN
TAMIL NADU,2005,Retired Person,0,0,0,10,84,94,0,0,0,0,8,8,102,TN
TAMIL NADU,2005,Total,147,1966,2707,1967,720,7507,172,1735,1365,923,374,4569,12076,TN
TAMIL NADU,2005,Total Salaried,0,342,508,397,64,1311,3,134,139,67,13,356,1667,TN
TAMIL NADU,2005,Total Self-employed,15,835,1287,947,387,3471,11,358,240,201,89,899,4370,TN
TRIPURA,2005,Others (Please Specify),4,19,24,17,11,75,8,74,21,11,2,116,191,TR
TRIPURA,2005,House Wife,0,0,0,0,0,0,0,47,38,15,4,104,104,TR
TRIPURA,2005,Service (Government),0,3,13,7,0,23,0,5,3,2,0,10,33,TR
TRIPURA,2005,Service (Private),0,8,15,11,0,34,0,6,5,3,0,14,48,TR
TRIPURA,2005,Public Sector Undertaking,0,8,9,5,0,22,0,3,4,5,0,12,34,TR
TRIPURA,2005,Student,6,22,1,0,0,29,8,28,4,0,0,40,69,TR
TRIPURA,2005,Unemployed,0,33,25,14,0,72,0,11,3,2,2,18,90,TR
TRIPURA,2005,Self-employed (Business activity),0,34,19,3,6,62,0,0,0,0,0,0,62,TR
TRIPURA,2005,Professional Activity,0,8,15,13,5,41,0,0,0,0,0,0,41,TR
TRIPURA,2005,Farming/Agriculture Activity,0,14,6,6,3,29,0,0,0,0,0,0,29,TR
TRIPURA,2005,Retired Person,0,0,0,7,7,14,0,0,0,0,0,0,14,TR
TRIPURA,2005,Total,10,149,127,83,32,401,16,174,78,38,8,314,715,TR
TRIPURA,2005,Total Salaried,0,19,37,23,0,79,0,14,12,10,0,36,115,TR
TRIPURA,2005,Total Self-employed,3,66,49,33,21,172,5,29,16,5,2,57,229,TR
UTTAR PRADESH,2005,Others (Please Specify),28,104,147,111,67,457,19,115,39,45,20,238,695,UP
UTTAR PRADESH,2005,House Wife,0,0,0,0,0,0,0,547,348,119,0,1014,1014,UP
UTTAR PRADESH,2005,Service (Government),0,8,16,11,0,35,0,8,3,2,0,13,48,UP
UTTAR PRADESH,2005,Service (Private),3,74,54,27,6,164,25,29,0,5,36,95,259,UP
UTTAR PRADESH,2005,Public Sector Undertaking,0,18,32,22,0,72,0,23,18,11,0,52,124,UP
UTTAR PRADESH,2005,Student,19,105,16,0,0,140,12,60,7,0,0,79,219,UP
UTTAR PRADESH,2005,Unemployed,2,69,91,26,7,195,0,39,24,9,0,72,267,UP
UTTAR PRADESH,2005,Self-employed (Business activity),2,68,76,42,32,220,2,1,5,0,0,8,228,UP
UTTAR PRADESH,2005,Professional Activity,1,13,17,24,6,61,0,1,2,0,0,3,64,UP
UTTAR PRADESH,2005,Farming/Agriculture Activity,3,108,164,103,44,422,1,41,27,15,16,100,522,UP
UTTAR PRADESH,2005,Retired Person,0,0,0,3,3,6,0,0,0,2,1,3,9,UP
UTTAR PRADESH,2005,Total,58,567,613,369,165,1772,59,864,473,208,73,1677,3449,UP
UTTAR PRADESH,2005,Total Salaried,3,100,102,60,6,271,25,60,21,18,36,160,431,UP
UTTAR PRADESH,2005,Total Self-employed,19,260,363,247,119,1008,14,133,61,46,24,278,1286,UP
UTTARAKHAND,2005,Others (Please Specify),0,24,11,6,4,45,1,1,1,3,0,6,51,UK
UTTARAKHAND,2005,House Wife,0,0,0,0,0,0,0,44,20,3,0,67,67,UK
UTTARAKHAND,2005,Service (Government),0,2,3,2,0,7,0,0,0,0,0,0,7,UK
UTTARAKHAND,2005,Service (Private),0,7,7,3,0,17,0,2,1,0,0,3,20,UK
UTTARAKHAND,2005,Public Sector Undertaking,0,3,3,0,0,6,0,1,0,0,0,1,7,UK
UTTARAKHAND,2005,Student,0,8,0,0,0,8,3,3,0,0,0,6,14,UK
UTTARAKHAND,2005,Unemployed,0,19,18,6,0,43,0,0,1,0,0,1,44,UK
UTTARAKHAND,2005,Self-employed (Business activity),0,7,16,2,1,26,0,0,0,0,0,0,26,UK
UTTARAKHAND,2005,Professional Activity,0,2,4,4,0,10,0,0,0,0,0,0,10,UK
UTTARAKHAND,2005,Farming/Agriculture Activity,0,4,4,5,2,15,0,3,3,3,0,9,24,UK
UTTARAKHAND,2005,Retired Person,0,0,0,1,2,3,0,0,0,0,0,0,3,UK
UTTARAKHAND,2005,Total,0,76,66,29,9,180,4,54,26,9,0,93,273,UK
UTTARAKHAND,2005,Total Salaried,0,12,13,5,0,30,0,3,1,0,0,4,34,UK
UTTARAKHAND,2005,Total Self-employed,0,21,32,15,3,71,0,4,3,4,0,11,82,UK
WEST BENGAL,2005,Others (Please Specify),73,997,1040,824,230,3164,41,538,306,244,78,1207,4371,WB
WEST BENGAL,2005,House Wife,0,0,0,0,0,0,0,1834,1296,830,195,4155,4155,WB
WEST BENGAL,2005,Service (Government),0,46,70,48,0,164,0,2,9,9,0,20,184,WB
WEST BENGAL,2005,Service (Private),0,418,464,237,0,1119,0,94,104,47,0,245,1364,WB
WEST BENGAL,2005,Public Sector Undertaking,0,97,222,152,0,471,0,32,12,2,0,46,517,WB
WEST BENGAL,2005,Student,141,285,27,0,0,453,164,102,12,0,0,278,731,WB
WEST BENGAL,2005,Unemployed,0,617,301,10,0,928,0,152,63,6,0,221,1149,WB
WEST BENGAL,2005,Self-employed (Business activity),0,212,351,307,34,904,0,11,56,8,21,96,1000,WB
WEST BENGAL,2005,Professional Activity,0,57,133,148,8,346,0,3,1,2,0,6,352,WB
WEST BENGAL,2005,Farming/Agriculture Activity,0,233,293,282,45,853,0,12,60,30,10,112,965,WB
WEST BENGAL,2005,Retired Person,0,0,0,0,212,212,0,0,0,0,15,15,227,WB
WEST BENGAL,2005,Total,214,2962,2901,2008,529,8614,205,2780,1919,1178,319,6401,15015,WB
WEST BENGAL,2005,Total Salaried,0,561,756,437,0,1754,0,128,125,58,0,311,2065,WB
WEST BENGAL,2005,Total Self-employed,0,874,1387,1265,289,3815,4,219,203,173,73,672,4487,WB
A & N ISLANDS,2006,Others (Please Specify),3,2,0,0,5,10,0,0,0,0,0,0,10,AN
A & N ISLANDS,2006,House Wife,0,0,0,0,0,0,0,18,10,3,2,33,33,AN
A & N ISLANDS,2006,Service (Government),0,3,4,4,0,11,0,0,0,0,0,0,11,AN
A & N ISLANDS,2006,Service (Private),0,10,28,18,6,62,0,1,0,0,0,1,63,AN
A & N ISLANDS,2006,Public Sector Undertaking,0,0,0,0,0,0,0,0,0,0,0,0,0,AN
A & N ISLANDS,2006,Student,1,0,0,0,0,1,1,2,0,0,0,3,4,AN
A & N ISLANDS,2006,Unemployed,0,2,0,0,0,2,0,0,0,0,0,0,2,AN
A & N ISLANDS,2006,Self-employed (Business activity),0,2,0,2,0,4,0,0,0,0,0,0,4,AN
A & N ISLANDS,2006,Professional Activity,0,0,0,0,0,0,0,0,0,0,0,0,0,AN
A & N ISLANDS,2006,Farming/Agriculture Activity,0,2,2,1,1,6,0,0,0,0,0,0,6,AN
A & N ISLANDS,2006,Retired Person,0,0,0,0,0,0,0,0,0,0,0,0,0,AN
A & N ISLANDS,2006,Total,4,21,34,25,12,96,1,21,10,3,2,37,133,AN
A & N ISLANDS,2006,Total Salaried,0,13,32,22,6,73,0,1,0,0,0,1,74,AN
A & N ISLANDS,2006,Total Self-employed,0,4,2,3,1,10,0,0,0,0,0,0,10,AN
ANDHRA PRADESH,2006,Others (Please Specify),95,1201,1416,798,301,3811,125,473,273,132,151,1154,4965,AP
ANDHRA PRADESH,2006,House Wife,0,0,0,0,0,0,2,994,750,303,107,2156,2156,AP
ANDHRA PRADESH,2006,Service (Government),4,51,84,44,0,183,0,19,26,3,0,48,231,AP
ANDHRA PRADESH,2006,Service (Private),0,157,240,159,20,576,0,30,35,6,0,71,647,AP
ANDHRA PRADESH,2006,Public Sector Undertaking,0,67,69,48,6,190,0,1,10,3,0,14,204,AP
ANDHRA PRADESH,2006,Student,55,216,12,4,0,287,53,168,4,0,0,225,512,AP
ANDHRA PRADESH,2006,Unemployed,0,169,132,70,0,371,0,34,24,0,0,58,429,AP
ANDHRA PRADESH,2006,Self-employed (Business activity),0,263,305,214,60,842,0,15,12,21,4,52,894,AP
ANDHRA PRADESH,2006,Professional Activity,0,66,240,197,49,552,1,12,8,0,1,22,574,AP
ANDHRA PRADESH,2006,Farming/Agriculture Activity,15,505,777,489,214,2000,14,241,210,115,27,607,2607,AP
ANDHRA PRADESH,2006,Retired Person,0,1,3,9,38,51,0,0,5,0,1,6,57,AP
ANDHRA PRADESH,2006,Total,169,2696,3278,2032,688,8863,195,1987,1357,583,291,4413,13276,AP
ANDHRA PRADESH,2006,Total Salaried,4,275,393,251,26,949,0,50,71,12,0,133,1082,AP
ANDHRA PRADESH,2006,Total Self-employed,61,1339,1973,1330,514,5217,86,537,375,219,142,1359,6576,AP
ARUNACHAL PRADESH,2006,Others (Please Specify),0,8,15,7,0,30,1,2,0,0,0,3,33,AR
ARUNACHAL PRADESH,2006,House Wife,0,0,0,0,0,0,0,7,11,3,0,21,21,AR
ARUNACHAL PRADESH,2006,Service (Government),0,2,9,7,0,18,0,0,1,0,0,1,19,AR
ARUNACHAL PRADESH,2006,Service (Private),0,11,12,4,1,28,0,0,0,0,0,0,28,AR
ARUNACHAL PRADESH,2006,Public Sector Undertaking,0,0,0,0,0,0,0,0,0,0,0,0,0,AR
ARUNACHAL PRADESH,2006,Student,1,1,0,0,0,2,2,6,0,0,0,8,10,AR
ARUNACHAL PRADESH,2006,Unemployed,0,3,5,1,0,9,0,0,0,0,0,0,9,AR
ARUNACHAL PRADESH,2006,Self-employed (Business activity),0,2,2,1,0,5,0,0,0,0,0,0,5,AR
ARUNACHAL PRADESH,2006,Professional Activity,0,0,0,0,0,0,0,0,0,0,0,0,0,AR
ARUNACHAL PRADESH,2006,Farming/Agriculture Activity,0,1,2,1,0,4,0,0,0,0,0,0,4,AR
ARUNACHAL PRADESH,2006,Retired Person,0,0,0,0,0,0,0,0,0,0,0,0,0,AR
ARUNACHAL PRADESH,2006,Total,1,28,45,21,1,96,3,15,12,3,0,33,129,AR
ARUNACHAL PRADESH,2006,Total Salaried,0,13,21,11,1,46,0,0,1,0,0,1,47,AR
ARUNACHAL PRADESH,2006,Total Self-employed,0,11,16,5,0,32,1,2,0,0,0,3,35,AR
ASSAM,2006,Others (Please Specify),16,330,379,137,53,915,11,80,65,22,9,187,1102,AS
ASSAM,2006,House Wife,0,0,0,0,0,0,0,258,247,68,6,579,579,AS
ASSAM,2006,Service (Government),0,6,6,5,0,17,0,0,0,0,0,0,17,AS
ASSAM,2006,Service (Private),0,14,19,5,0,38,0,4,3,1,0,8,46,AS
ASSAM,2006,Public Sector Undertaking,0,18,10,11,0,39,0,9,5,0,0,14,53,AS
ASSAM,2006,Student,27,127,3,0,0,157,19,32,2,0,0,53,210,AS
ASSAM,2006,Unemployed,0,0,15,24,2,41,0,0,0,0,0,0,41,AS
ASSAM,2006,Self-employed (Business activity),0,148,199,118,1,466,0,28,13,6,0,47,513,AS
ASSAM,2006,Professional Activity,1,26,82,29,0,138,0,0,0,0,0,0,138,AS
ASSAM,2006,Farming/Agriculture Activity,0,82,139,54,20,295,2,2,13,10,0,27,322,AS
ASSAM,2006,Retired Person,0,2,1,2,5,10,0,0,0,0,0,0,10,AS
ASSAM,2006,Total,44,753,853,385,81,2116,32,413,348,107,15,915,3031,AS
ASSAM,2006,Total Salaried,0,38,35,21,0,94,0,13,8,1,0,22,116,AS
ASSAM,2006,Total Self-employed,10,517,730,307,44,1608,6,57,61,30,8,162,1770,AS
BIHAR,2006,Others (Please Specify),18,57,46,29,7,157,15,43,35,23,3,119,276,BR
BIHAR,2006,House Wife,0,0,0,0,0,0,0,56,68,12,1,137,137,BR
BIHAR,2006,Service (Government),0,1,3,2,0,6,0,1,3,0,0,4,10,BR
BIHAR,2006,Service (Private),0,5,9,1,0,15,0,0,0,1,0,1,16,BR
BIHAR,2006,Public Sector Undertaking,0,1,1,0,0,2,0,0,5,0,0,5,7,BR
BIHAR,2006,Student,10,30,3,0,0,43,8,14,5,0,0,27,70,BR
BIHAR,2006,Unemployed,0,8,9,0,1,18,1,4,2,1,0,8,26,BR
BIHAR,2006,Self-employed (Business activity),0,7,8,1,0,16,0,1,7,0,0,8,24,BR
BIHAR,2006,Professional Activity,0,1,2,0,0,3,0,0,0,1,0,1,4,BR
BIHAR,2006,Farming/Agriculture Activity,0,13,21,2,2,38,0,4,4,0,0,8,46,BR
BIHAR,2006,Retired Person,0,0,0,0,1,1,0,0,0,0,1,1,2,BR
BIHAR,2006,Total,28,123,102,35,11,299,24,123,129,38,5,319,618,BR
BIHAR,2006,Total Salaried,0,7,13,3,0,23,0,1,8,1,0,10,33,BR
BIHAR,2006,Total Self-employed,0,34,46,16,3,99,1,18,27,4,0,50,149,BR
CHANDIGARH,2006,Others (Please Specify),0,0,0,0,0,0,0,0,0,0,0,0,0,CH
CHANDIGARH,2006,House Wife,0,0,0,0,0,0,0,3,6,1,1,11,11,CH
CHANDIGARH,2006,Service (Government),0,2,3,2,0,7,0,0,0,0,0,0,7,CH
CHANDIGARH,2006,Service (Private),0,5,8,0,0,13,0,2,0,0,0,2,15,CH
CHANDIGARH,2006,Public Sector Undertaking,0,0,0,0,0,0,0,0,0,0,0,0,0,CH
CHANDIGARH,2006,Student,0,11,0,0,0,11,2,7,0,0,0,9,20,CH
CHANDIGARH,2006,Unemployed,0,7,15,1,0,23,0,2,0,0,0,2,25,CH
CHANDIGARH,2006,Self-employed (Business activity),0,0,0,0,1,1,0,0,0,0,0,0,1,CH
CHANDIGARH,2006,Professional Activity,0,0,0,0,0,0,0,0,0,0,0,0,0,CH
CHANDIGARH,2006,Farming/Agriculture Activity,0,1,0,0,0,1,0,0,0,0,0,0,1,CH
CHANDIGARH,2006,Retired Person,0,0,0,0,0,0,0,0,0,0,0,0,0,CH
CHANDIGARH,2006,Total,0,26,26,3,1,56,2,14,6,1,1,24,80,CH
CHANDIGARH,2006,Total Salaried,0,7,11,2,0,20,0,2,0,0,0,2,22,CH
CHANDIGARH,2006,Total Self-employed,0,1,0,0,1,2,0,0,0,0,0,0,2,CH
CHHATTISGARH,2006,Others (Please Specify),82,429,375,249,91,1226,56,176,86,54,22,394,1620,CG
CHHATTISGARH,2006,House Wife,0,0,0,0,0,0,3,393,248,83,45,772,772,CG
CHHATTISGARH,2006,Service (Government),0,6,13,11,1,31,0,1,2,1,0,4,35,CG
CHHATTISGARH,2006,Service (Private),0,24,60,43,0,127,0,4,5,0,0,9,136,CG
CHHATTISGARH,2006,Public Sector Undertaking,0,0,14,2,0,16,0,0,1,0,0,1,17,CG
CHHATTISGARH,2006,Student,23,84,0,0,0,107,16,69,0,0,0,85,192,CG
CHHATTISGARH,2006,Unemployed,0,93,41,10,0,144,1,5,1,1,0,8,152,CG
CHHATTISGARH,2006,Self-employed (Business activity),0,29,63,17,4,113,0,12,2,8,0,22,135,CG
CHHATTISGARH,2006,Professional Activity,1,25,38,13,6,83,0,0,0,0,0,0,83,CG
CHHATTISGARH,2006,Farming/Agriculture Activity,6,377,481,245,103,1212,20,115,83,41,12,271,1483,CG
CHHATTISGARH,2006,Retired Person,0,0,0,0,1,1,0,0,0,0,0,0,1,CG
CHHATTISGARH,2006,Total,112,1067,1085,590,206,3060,96,775,428,188,79,1566,4626,CG
CHHATTISGARH,2006,Total Salaried,0,30,87,56,1,174,0,5,8,1,0,14,188,CG
CHHATTISGARH,2006,Total Self-employed,31,610,760,380,134,1915,37,211,113,72,16,449,2364,CG
D & N HAVELI,2006,Others (Please Specify),0,0,0,0,0,0,0,0,0,0,0,0,0,DN
D & N HAVELI,2006,House Wife,0,0,0,0,0,0,0,7,6,2,2,17,17,DN
D & N HAVELI,2006,Service (Government),0,0,0,0,0,0,0,0,0,0,0,0,0,DN
D & N HAVELI,2006,Service (Private),0,2,0,0,1,3,0,0,0,0,0,0,3,DN
D & N HAVELI,2006,Public Sector Undertaking,0,0,0,0,0,0,0,0,0,0,0,0,0,DN
D & N HAVELI,2006,Student,0,2,0,0,0,2,0,0,0,0,0,0,2,DN
D & N HAVELI,2006,Unemployed,0,3,2,0,0,5,1,1,0,0,0,2,7,DN
D & N HAVELI,2006,Self-employed (Business activity),0,0,1,0,0,1,0,0,0,0,0,0,1,DN
D & N HAVELI,2006,Professional Activity,0,0,0,0,0,0,0,0,0,0,0,0,0,DN
D & N HAVELI,2006,Farming/Agriculture Activity,0,1,2,3,6,12,0,0,0,0,0,0,12,DN
D & N HAVELI,2006,Retired Person,0,0,0,0,0,0,0,0,0,0,0,0,0,DN
D & N HAVELI,2006,Total,0,8,5,3,7,23,1,8,6,2,2,19,42,DN
D & N HAVELI,2006,Total Salaried,0,2,0,0,1,3,0,0,0,0,0,0,3,DN
D & N HAVELI,2006,Total Self-employed,0,1,3,3,6,13,0,0,0,0,0,0,13,DN
DAMAN & DIU,2006,Others (Please Specify),0,0,2,1,1,4,2,0,1,0,0,3,7,DD
DAMAN & DIU,2006,House Wife,0,0,0,0,0,0,0,3,0,0,0,3,3,DD
DAMAN & DIU,2006,Service (Government),0,0,0,0,0,0,0,0,0,0,0,0,0,DD
DAMAN & DIU,2006,Service (Private),0,6,2,0,0,8,0,0,0,0,0,0,8,DD
DAMAN & DIU,2006,Public Sector Undertaking,0,0,0,0,0,0,0,0,0,0,0,0,0,DD
DAMAN & DIU,2006,Student,0,1,0,0,0,1,1,1,0,0,0,2,3,DD
DAMAN & DIU,2006,Unemployed,0,0,0,0,0,0,0,0,0,0,0,0,0,DD
DAMAN & DIU,2006,Self-employed (Business activity),0,0,1,0,0,1,0,0,0,0,0,0,1,DD
DAMAN & DIU,2006,Professional Activity,0,0,0,0,0,0,0,0,0,0,0,0,0,DD
DAMAN & DIU,2006,Farming/Agriculture Activity,0,0,0,0,0,0,0,0,0,0,0,0,0,DD
DAMAN & DIU,2006,Retired Person,0,0,0,0,0,0,0,0,0,0,0,0,0,DD
DAMAN & DIU,2006,Total,0,7,5,1,1,14,3,4,1,0,0,8,22,DD
DAMAN & DIU,2006,Total Salaried,0,6,2,0,0,8,0,0,0,0,0,0,8,DD
DAMAN & DIU,2006,Total Self-employed,0,0,3,0,0,3,0,0,0,0,0,0,3,DD
DELHI (UT),2006,Others (Please Specify),5,100,108,55,17,285,5,32,25,4,1,67,352,DL
DELHI (UT),2006,House Wife,0,0,0,0,0,0,0,194,111,24,2,331,331,DL
DELHI (UT),2006,Service (Government),0,4,15,8,0,27,0,1,3,0,0,4,31,DL
DELHI (UT),2006,Service (Private),0,116,94,37,1,248,0,15,2,0,0,17,265,DL
DELHI (UT),2006,Public Sector Undertaking,0,10,11,1,0,22,1,2,0,0,0,3,25,DL
DELHI (UT),2006,Student,3,52,0,0,0,55,9,53,1,0,0,63,118,DL
DELHI (UT),2006,Unemployed,1,150,90,33,3,277,1,32,5,0,2,40,317,DL
DELHI (UT),2006,Self-employed (Business activity),0,7,13,1,1,22,0,6,1,0,0,7,29,DL
DELHI (UT),2006,Professional Activity,0,1,1,2,0,4,0,0,0,0,0,0,4,DL
DELHI (UT),2006,Farming/Agriculture Activity,0,0,3,0,0,3,0,0,0,0,0,0,3,DL
DELHI (UT),2006,Retired Person,0,9,5,2,1,17,0,0,0,0,0,0,17,DL
DELHI (UT),2006,Total,9,449,340,139,23,960,16,335,148,28,5,532,1492,DL
DELHI (UT),2006,Total Salaried,0,130,120,46,1,297,1,18,5,0,0,24,321,DL
DELHI (UT),2006,Total Self-employed,4,77,99,47,13,240,2,27,24,2,0,55,295,DL
GOA,2006,Others (Please Specify),0,10,21,14,5,50,2,7,3,0,1,13,63,GA
GOA,2006,House Wife,0,0,0,0,0,0,0,12,16,13,10,51,51,GA
GOA,2006,Service (Government),0,2,1,0,0,3,0,0,0,0,0,0,3,GA
GOA,2006,Service (Private),0,20,18,11,0,49,0,3,1,0,0,4,53,GA
GOA,2006,Public Sector Undertaking,0,0,0,0,0,0,0,0,0,0,0,0,0,GA
GOA,2006,Student,1,7,0,0,0,8,4,8,0,0,0,12,20,GA
GOA,2006,Unemployed,0,19,22,8,2,51,0,10,2,0,0,12,63,GA
GOA,2006,Self-employed (Business activity),0,2,2,5,0,9,0,0,0,0,0,0,9,GA
GOA,2006,Professional Activity,0,0,0,0,0,0,0,0,0,0,0,0,0,GA
GOA,2006,Farming/Agriculture Activity,0,0,5,0,0,5,0,0,0,0,0,0,5,GA
GOA,2006,Retired Person,0,0,0,2,6,8,0,0,0,0,0,0,8,GA
GOA,2006,Total,1,60,69,40,13,183,6,40,22,13,11,92,275,GA
GOA,2006,Total Salaried,0,22,19,11,0,52,0,3,1,0,0,4,56,GA
GOA,2006,Total Self-employed,0,3,12,9,3,27,0,1,0,0,0,1,28,GA
GUJARAT,2006,Others (Please Specify),6,260,288,187,62,803,6,83,44,38,9,180,983,GJ
GUJARAT,2006,House Wife,0,0,0,0,0,0,0,651,469,219,57,1396,1396,GJ
GUJARAT,2006,Service (Government),0,8,22,14,1,45,0,5,3,1,0,9,54,GJ
GUJARAT,2006,Service (Private),0,141,215,102,3,461,0,37,25,8,0,70,531,GJ
GUJARAT,2006,Public Sector Undertaking,0,13,17,10,1,41,0,10,4,1,0,15,56,GJ
GUJARAT,2006,Student,24,100,13,0,0,137,17,85,1,0,0,103,240,GJ
GUJARAT,2006,Unemployed,0,162,154,86,8,410,0,19,22,5,0,46,456,GJ
GUJARAT,2006,Self-employed (Business activity),0,73,108,68,8,257,0,1,5,0,0,6,263,GJ
GUJARAT,2006,Professional Activity,0,126,141,87,16,370,2,10,12,5,0,29,399,GJ
GUJARAT,2006,Farming/Agriculture Activity,0,101,175,116,19,411,3,24,29,14,6,76,487,GJ
GUJARAT,2006,Retired Person,0,2,1,24,86,113,0,0,0,7,50,57,170,GJ
GUJARAT,2006,Total,30,986,1134,694,204,3048,28,925,614,298,122,1987,5035,GJ
GUJARAT,2006,Total Salaried,0,162,254,126,5,547,0,52,32,10,0,94,641,GJ
GUJARAT,2006,Total Self-employed,2,465,600,381,67,1515,8,83,69,28,9,197,1712,GJ
HARYANA,2006,Others (Please Specify),15,203,251,131,41,641,9,19,17,13,9,67,708,HR
HARYANA,2006,House Wife,0,0,0,0,0,0,2,152,110,40,15,319,319,HR
HARYANA,2006,Service (Government),0,13,28,8,0,49,0,5,5,0,0,10,59,HR
HARYANA,2006,Service (Private),0,129,127,58,7,321,0,12,23,15,4,54,375,HR
HARYANA,2006,Public Sector Undertaking,0,14,50,14,0,78,0,16,5,0,0,21,99,HR
HARYANA,2006,Student,8,75,3,0,0,86,10,30,0,0,0,40,126,HR
HARYANA,2006,Unemployed,1,81,105,51,5,243,0,5,7,2,1,15,258,HR
HARYANA,2006,Self-employed (Business activity),0,17,33,25,14,89,0,4,8,0,0,12,101,HR
HARYANA,2006,Professional Activity,0,10,8,6,0,24,0,2,0,0,0,2,26,HR
HARYANA,2006,Farming/Agriculture Activity,0,48,78,35,20,181,0,6,2,1,0,9,190,HR
HARYANA,2006,Retired Person,1,20,18,10,5,54,0,1,0,0,0,1,55,HR
HARYANA,2006,Total,25,610,701,338,92,1766,21,252,177,71,29,550,2316,HR
HARYANA,2006,Total Salaried,0,156,205,80,7,448,0,33,33,15,4,85,533,HR
HARYANA,2006,Total Self-employed,2,163,194,106,47,512,0,14,15,6,3,38,550,HR
HIMACHAL PRADESH,2006,Others (Please Specify),0,27,34,25,11,97,0,11,19,12,4,46,143,HP
HIMACHAL PRADESH,2006,House Wife,0,0,0,0,0,0,0,31,22,21,4,78,78,HP
HIMACHAL PRADESH,2006,Service (Government),0,7,8,6,0,21,0,0,0,1,0,1,22,HP
HIMACHAL PRADESH,2006,Service (Private),0,12,19,15,1,47,0,6,1,3,0,10,57,HP
HIMACHAL PRADESH,2006,Public Sector Undertaking,0,10,24,4,2,40,0,1,0,0,0,1,41,HP
HIMACHAL PRADESH,2006,Student,4,14,2,0,0,20,1,18,1,0,0,20,40,HP
HIMACHAL PRADESH,2006,Unemployed,0,10,13,8,1,32,0,0,0,0,0,0,32,HP
HIMACHAL PRADESH,2006,Self-employed (Business activity),0,3,7,3,4,17,0,0,0,0,0,0,17,HP
HIMACHAL PRADESH,2006,Professional Activity,0,0,3,1,0,4,0,0,0,0,0,0,4,HP
HIMACHAL PRADESH,2006,Farming/Agriculture Activity,0,7,11,3,1,22,0,0,0,0,0,0,22,HP
HIMACHAL PRADESH,2006,Retired Person,0,0,0,0,1,1,0,0,0,0,0,0,1,HP
HIMACHAL PRADESH,2006,Total,4,90,121,65,21,301,1,67,43,37,8,156,457,HP
HIMACHAL PRADESH,2006,Total Salaried,0,29,51,25,3,108,0,7,1,4,0,12,120,HP
HIMACHAL PRADESH,2006,Total Self-employed,0,12,21,7,5,45,0,0,0,0,0,0,45,HP
JAMMU & KASHMIR,2006,Others (Please Specify),0,17,21,11,2,51,0,16,9,4,0,29,80,JK
JAMMU & KASHMIR,2006,House Wife,0,0,0,0,0,0,0,20,20,2,0,42,42,JK
JAMMU & KASHMIR,2006,Service (Government),0,11,9,4,0,24,0,2,1,0,0,3,27,JK
JAMMU & KASHMIR,2006,Service (Private),0,2,2,3,1,8,0,2,1,1,0,4,12,JK
JAMMU & KASHMIR,2006,Public Sector Undertaking,0,1,0,1,0,2,0,0,0,0,0,0,2,JK
JAMMU & KASHMIR,2006,Student,0,7,0,0,0,7,0,15,0,0,0,15,22,JK
JAMMU & KASHMIR,2006,Unemployed,0,15,11,0,0,26,0,6,1,1,0,8,34,JK
JAMMU & KASHMIR,2006,Self-employed (Business activity),0,1,1,0,0,2,0,0,0,0,0,0,2,JK
JAMMU & KASHMIR,2006,Professional Activity,0,0,0,0,0,0,0,5,0,0,0,5,5,JK
JAMMU & KASHMIR,2006,Farming/Agriculture Activity,1,10,12,6,1,30,0,2,1,1,0,4,34,JK
JAMMU & KASHMIR,2006,Retired Person,0,0,0,0,2,2,0,0,0,0,0,0,2,JK
JAMMU & KASHMIR,2006,Total,1,64,56,25,6,152,0,68,33,9,0,110,262,JK
JAMMU & KASHMIR,2006,Total Salaried,0,14,11,8,1,34,0,4,2,1,0,7,41,JK
JAMMU & KASHMIR,2006,Total Self-employed,1,17,19,13,2,52,0,15,6,5,0,26,78,JK
JHARKHAND,2006,Others (Please Specify),11,37,56,26,14,144,8,20,32,13,2,75,219,JH
JHARKHAND,2006,House Wife,0,0,0,0,0,0,1,94,70,23,2,190,190,JH
JHARKHAND,2006,Service (Government),0,5,5,10,0,20,0,0,6,0,0,6,26,JH
JHARKHAND,2006,Service (Private),0,20,12,8,0,40,0,2,5,1,0,8,48,JH
JHARKHAND,2006,Public Sector Undertaking,0,1,0,0,0,1,0,0,0,0,0,0,1,JH
JHARKHAND,2006,Student,10,58,1,2,0,71,5,35,0,0,0,40,111,JH
JHARKHAND,2006,Unemployed,0,31,37,12,1,81,1,6,7,0,0,14,95,JH
JHARKHAND,2006,Self-employed (Business activity),0,12,4,2,0,18,0,1,0,1,0,2,20,JH
JHARKHAND,2006,Professional Activity,0,5,24,5,0,34,0,0,0,0,0,0,34,JH
JHARKHAND,2006,Farming/Agriculture Activity,0,19,53,30,1,103,0,0,0,0,0,0,103,JH
JHARKHAND,2006,Retired Person,0,2,1,0,6,9,0,0,0,0,0,0,9,JH
JHARKHAND,2006,Total,21,190,193,95,22,521,15,158,120,38,4,335,856,JH
JHARKHAND,2006,Total Salaried,0,26,17,18,0,61,0,2,11,1,0,14,75,JH
JHARKHAND,2006,Total Self-employed,4,57,99,44,4,208,2,3,0,1,0,6,214,JH
KARNATAKA,2006,Others (Please Specify),108,1027,1412,945,456,3948,86,628,471,200,91,1476,5424,KA
KARNATAKA,2006,House Wife,0,0,0,0,0,0,0,697,649,369,136,1851,1851,KA
KARNATAKA,2006,Service (Government),0,68,71,75,0,214,0,11,6,7,0,24,238,KA
KARNATAKA,2006,Service (Private),2,285,362,343,46,1038,0,65,48,28,3,144,1182,KA
KARNATAKA,2006,Public Sector Undertaking,0,47,41,43,5,136,0,16,9,8,1,34,170,KA
KARNATAKA,2006,Student,25,173,15,14,3,230,38,174,5,0,0,217,447,KA
KARNATAKA,2006,Unemployed,0,162,146,59,31,398,0,53,14,16,7,90,488,KA
KARNATAKA,2006,Self-employed (Business activity),2,133,140,101,20,396,1,15,22,4,2,44,440,KA
KARNATAKA,2006,Professional Activity,12,64,76,44,14,210,1,4,4,2,2,13,223,KA
KARNATAKA,2006,Farming/Agriculture Activity,2,348,576,395,129,1450,5,90,97,56,22,270,1720,KA
KARNATAKA,2006,Retired Person,0,0,1,6,21,28,0,0,0,0,1,1,29,KA
KARNATAKA,2006,Total,151,2307,2840,2025,725,8048,131,1753,1325,690,265,4164,12212,KA
KARNATAKA,2006,Total Salaried,2,400,474,461,51,1388,0,92,63,43,4,202,1590,KA
KARNATAKA,2006,Total Self-employed,30,922,1414,1020,369,3755,13,254,232,134,55,688,4443,KA
KERALA,2006,Others (Please Specify),8,534,934,1036,731,3243,7,137,110,116,117,487,3730,KL
KERALA,2006,House Wife,0,0,0,0,0,0,0,289,404,388,269,1350,1350,KL
KERALA,2006,Service (Government),0,3,31,41,0,75,0,2,5,7,0,14,89,KL
KERALA,2006,Service (Private),0,75,148,134,13,370,0,27,27,7,1,62,432,KL
KERALA,2006,Public Sector Undertaking,0,3,29,22,4,58,0,4,7,7,2,20,78,KL
KERALA,2006,Student,45,71,0,0,0,116,53,102,0,0,0,155,271,KL
KERALA,2006,Unemployed,1,210,348,283,157,999,0,101,54,29,34,218,1217,KL
KERALA,2006,Self-employed (Business activity),0,41,138,156,38,373,0,3,0,1,0,4,377,KL
KERALA,2006,Professional Activity,0,43,82,69,16,210,0,8,7,5,0,20,230,KL
KERALA,2006,Farming/Agriculture Activity,0,86,273,420,249,1028,0,9,26,37,24,96,1124,KL
KERALA,2006,Retired Person,0,0,8,38,65,111,0,0,0,5,12,17,128,KL
KERALA,2006,Total,54,1066,1991,2199,1273,6583,60,682,640,602,459,2443,9026,KL
KERALA,2006,Total Salaried,0,81,208,197,17,503,0,33,39,21,3,96,599,KL
KERALA,2006,Total Self-employed,5,559,1178,1355,827,3924,6,123,119,122,107,477,4401,KL
LAKSHADWEEP,2006,Others (Please Specify),0,0,0,0,0,0,0,0,0,0,0,0,0,LD
LAKSHADWEEP,2006,House Wife,0,0,0,0,0,0,0,1,0,0,0,1,1,LD
LAKSHADWEEP,2006,Service (Government),0,0,1,0,0,1,0,0,0,0,0,0,1,LD
LAKSHADWEEP,2006,Service (Private),0,0,0,0,0,0,0,0,0,0,0,0,0,LD
LAKSHADWEEP,2006,Public Sector Undertaking,0,0,0,0,0,0,0,0,0,0,0,0,0,LD
LAKSHADWEEP,2006,Student,0,0,0,0,0,0,0,0,0,0,0,0,0,LD
LAKSHADWEEP,2006,Unemployed,0,0,0,0,0,0,0,0,0,0,0,0,0,LD
LAKSHADWEEP,2006,Self-employed (Business activity),0,0,0,0,0,0,0,0,0,0,0,0,0,LD
LAKSHADWEEP,2006,Professional Activity,0,0,0,0,0,0,0,0,0,0,0,0,0,LD
LAKSHADWEEP,2006,Farming/Agriculture Activity,0,0,0,0,0,0,0,0,0,0,0,0,0,LD
LAKSHADWEEP,2006,Retired Person,0,0,0,0,0,0,0,0,0,0,0,0,0,LD
LAKSHADWEEP,2006,Total,0,0,1,0,0,1,0,1,0,0,0,1,2,LD
LAKSHADWEEP,2006,Total Salaried,0,0,1,0,0,1,0,0,0,0,0,0,1,LD
LAKSHADWEEP,2006,Total Self-employed,0,0,0,0,0,0,0,0,0,0,0,0,0,LD
MADHYA PRADESH,2006,Others (Please Specify),30,327,410,249,105,1121,27,211,178,61,27,504,1625,MP
MADHYA PRADESH,2006,House Wife,0,0,0,0,0,0,13,1026,595,184,83,1901,1901,MP
MADHYA PRADESH,2006,Service (Government),1,18,22,27,0,68,0,20,8,0,0,28,96,MP
MADHYA PRADESH,2006,Service (Private),2,64,72,51,9,198,0,49,15,4,1,69,267,MP
MADHYA PRADESH,2006,Public Sector Undertaking,2,37,45,17,4,105,2,14,4,4,0,24,129,MP
MADHYA PRADESH,2006,Student,36,140,12,5,5,198,36,111,15,5,0,167,365,MP
MADHYA PRADESH,2006,Unemployed,2,124,76,52,20,274,0,9,6,7,0,22,296,MP
MADHYA PRADESH,2006,Self-employed (Business activity),3,46,84,46,20,199,0,6,2,0,0,8,207,MP
MADHYA PRADESH,2006,Professional Activity,0,62,58,25,8,153,0,3,5,2,2,12,165,MP
MADHYA PRADESH,2006,Farming/Agriculture Activity,20,349,448,241,120,1178,5,110,62,18,2,197,1375,MP
MADHYA PRADESH,2006,Retired Person,0,0,0,1,8,9,0,0,0,0,0,0,9,MP
MADHYA PRADESH,2006,Total,96,1167,1227,714,299,3503,83,1559,890,285,115,2932,6435,MP
MADHYA PRADESH,2006,Total Salaried,5,119,139,95,13,371,2,83,27,8,1,121,492,MP
MADHYA PRADESH,2006,Total Self-employed,37,655,834,460,219,2205,17,222,130,38,18,425,2630,MP
MAHARASHTRA,2006,Others (Please Specify),3,533,804,458,195,1993,9,89,83,28,21,230,2223,MH
MAHARASHTRA,2006,House Wife,0,0,0,0,0,0,1,1911,1067,409,265,3653,3653,MH
MAHARASHTRA,2006,Service (Government),0,95,202,135,0,432,0,19,25,6,0,50,482,MH
MAHARASHTRA,2006,Service (Private),0,400,536,271,34,1241,0,64,27,11,2,104,1345,MH
MAHARASHTRA,2006,Public Sector Undertaking,0,37,78,40,5,160,0,5,6,1,0,12,172,MH
MAHARASHTRA,2006,Student,54,389,1,0,0,444,70,368,0,0,0,438,882,MH
MAHARASHTRA,2006,Unemployed,4,388,341,108,31,872,2,52,12,6,0,72,944,MH
MAHARASHTRA,2006,Self-employed (Business activity),0,148,203,98,23,472,0,8,10,0,1,19,491,MH
MAHARASHTRA,2006,Professional Activity,0,156,287,159,51,653,0,25,23,7,1,56,709,MH
MAHARASHTRA,2006,Farming/Agriculture Activity,7,942,1589,1032,541,4111,3,142,113,57,27,342,4453,MH
MAHARASHTRA,2006,Retired Person,0,0,1,25,106,132,0,0,0,0,8,8,140,MH
MAHARASHTRA,2006,Total,68,3088,4042,2326,986,10510,85,2683,1366,525,325,4984,15494,MH
MAHARASHTRA,2006,Total Salaried,0,532,816,446,39,1833,0,88,58,18,2,166,1999,MH
MAHARASHTRA,2006,Total Self-employed,10,1709,2791,1698,785,6993,9,257,223,92,50,631,7624,MH
MANIPUR,2006,Others (Please Specify),0,0,1,1,0,2,0,0,0,0,0,0,2,MN
MANIPUR,2006,House Wife,0,0,0,0,0,0,0,2,1,0,0,3,3,MN
MANIPUR,2006,Service (Government),0,3,8,2,0,13,0,0,0,0,0,0,13,MN
MANIPUR,2006,Service (Private),0,0,0,0,0,0,0,0,0,0,0,0,0,MN
MANIPUR,2006,Public Sector Undertaking,0,0,0,0,0,0,0,0,0,0,0,0,0,MN
MANIPUR,2006,Student,0,4,0,0,0,4,0,9,0,0,0,9,13,MN
MANIPUR,2006,Unemployed,0,0,2,2,1,5,0,0,0,0,0,0,5,MN
MANIPUR,2006,Self-employed (Business activity),0,0,0,0,0,0,0,0,0,0,0,0,0,MN
MANIPUR,2006,Professional Activity,0,0,0,0,0,0,0,0,0,0,0,0,0,MN
MANIPUR,2006,Farming/Agriculture Activity,0,0,0,0,0,0,0,0,0,0,0,0,0,MN
MANIPUR,2006,Retired Person,0,0,0,0,0,0,0,0,0,0,0,0,0,MN
MANIPUR,2006,Total,0,7,11,5,1,24,0,11,1,0,0,12,36,MN
MANIPUR,2006,Total Salaried,0,3,8,2,0,13,0,0,0,0,0,0,13,MN
MANIPUR,2006,Total Self-employed,0,0,0,1,0,1,0,0,0,0,0,0,1,MN
MEGHALAYA,2006,Others (Please Specify),0,8,6,2,4,20,0,4,0,0,0,4,24,ML
MEGHALAYA,2006,House Wife,0,0,0,0,0,0,0,6,5,0,0,11,11,ML
MEGHALAYA,2006,Service (Government),0,3,5,0,0,8,0,0,0,0,0,0,8,ML
MEGHALAYA,2006,Service (Private),0,1,2,2,0,5,0,0,0,0,0,0,5,ML
MEGHALAYA,2006,Public Sector Undertaking,0,0,1,0,0,1,0,0,0,0,0,0,1,ML
MEGHALAYA,2006,Student,1,3,0,0,0,4,1,5,0,0,0,6,10,ML
MEGHALAYA,2006,Unemployed,0,9,1,0,0,10,0,2,0,0,0,2,12,ML
MEGHALAYA,2006,Self-employed (Business activity),0,15,3,0,0,18,0,0,0,0,0,0,18,ML
MEGHALAYA,2006,Professional Activity,0,0,0,0,0,0,0,0,0,0,0,0,0,ML
MEGHALAYA,2006,Farming/Agriculture Activity,0,1,1,1,0,3,0,0,0,0,0,0,3,ML
MEGHALAYA,2006,Retired Person,0,0,0,0,0,0,0,0,0,0,0,0,0,ML
MEGHALAYA,2006,Total,1,40,19,5,4,69,1,17,5,0,0,23,92,ML
MEGHALAYA,2006,Total Salaried,0,4,8,2,0,14,0,0,0,0,0,0,14,ML
MEGHALAYA,2006,Total Self-employed,0,21,9,2,3,35,0,3,0,0,0,3,38,ML
MIZORAM,2006,Others (Please Specify),0,16,17,1,4,38,0,4,2,0,0,6,44,MZ
MIZORAM,2006,House Wife,0,0,0,0,0,0,0,1,0,3,0,4,4,MZ
MIZORAM,2006,Service (Government),0,2,2,1,0,5,0,0,0,0,0,0,5,MZ
MIZORAM,2006,Service (Private),0,3,0,0,0,3,0,0,0,0,0,0,3,MZ
MIZORAM,2006,Public Sector Undertaking,0,3,0,0,0,3,0,0,0,0,0,0,3,MZ
MIZORAM,2006,Student,0,2,2,0,0,4,0,0,0,0,0,0,4,MZ
MIZORAM,2006,Unemployed,0,5,0,1,0,6,0,0,0,0,0,0,6,MZ
MIZORAM,2006,Self-employed (Business activity),0,0,0,0,0,0,0,0,0,0,0,0,0,MZ
MIZORAM,2006,Professional Activity,0,0,0,0,0,0,0,0,0,0,0,0,0,MZ
MIZORAM,2006,Farming/Agriculture Activity,0,0,1,0,0,1,0,0,0,0,0,0,1,MZ
MIZORAM,2006,Retired Person,0,0,0,0,0,0,0,0,0,0,0,0,0,MZ
MIZORAM,2006,Total,0,31,22,3,4,60,0,5,2,3,0,10,70,MZ
MIZORAM,2006,Total Salaried,0,8,2,1,0,11,0,0,0,0,0,0,11,MZ
MIZORAM,2006,Total Self-employed,0,2,1,1,2,6,0,0,0,0,0,0,6,MZ
NAGALAND,2006,Others (Please Specify),0,1,1,1,0,3,0,3,0,0,0,3,6,NG
NAGALAND,2006,House Wife,0,0,0,0,0,0,0,0,4,1,0,5,5,NG
NAGALAND,2006,Service (Government),0,3,2,0,0,5,0,0,0,0,0,0,5,NG
NAGALAND,2006,Service (Private),0,0,0,0,0,0,0,0,0,0,0,0,0,NG
NAGALAND,2006,Public Sector Undertaking,0,0,0,0,0,0,0,0,0,0,0,0,0,NG
NAGALAND,2006,Student,0,1,1,0,0,2,0,0,0,0,0,0,2,NG
NAGALAND,2006,Unemployed,1,4,2,0,0,7,0,0,0,0,0,0,7,NG
NAGALAND,2006,Self-employed (Business activity),0,0,0,1,0,1,0,0,0,0,0,0,1,NG
NAGALAND,2006,Professional Activity,0,0,0,0,0,0,0,0,0,0,0,0,0,NG
NAGALAND,2006,Farming/Agriculture Activity,0,0,0,1,0,1,0,1,0,0,0,1,2,NG
NAGALAND,2006,Retired Person,0,0,0,0,0,0,0,0,0,0,0,0,0,NG
NAGALAND,2006,Total,1,9,6,3,0,19,0,4,4,1,0,9,28,NG
NAGALAND,2006,Total Salaried,0,3,2,0,0,5,0,0,0,0,0,0,5,NG
NAGALAND,2006,Total Self-employed,0,1,1,3,0,5,0,3,0,0,0,3,8,NG
ODISHA,2006,Others (Please Specify),21,317,419,272,142,1171,28,257,243,123,43,694,1865,OD
ODISHA,2006,House Wife,0,0,0,0,0,0,0,254,191,64,22,531,531,OD
ODISHA,2006,Service (Government),0,6,8,4,0,18,0,4,1,0,0,5,23,OD
ODISHA,2006,Service (Private),0,45,51,30,7,133,0,37,32,23,0,92,225,OD
ODISHA,2006,Public Sector Undertaking,0,8,16,8,0,32,0,8,9,0,0,17,49,OD
ODISHA,2006,Student,18,80,14,0,0,112,29,98,32,0,0,159,271,OD
ODISHA,2006,Unemployed,0,128,136,32,11,307,0,57,33,10,0,100,407,OD
ODISHA,2006,Self-employed (Business activity),0,58,118,66,16,258,1,13,10,10,0,34,292,OD
ODISHA,2006,Professional Activity,2,23,29,26,3,83,1,12,2,2,0,17,100,OD
ODISHA,2006,Farming/Agriculture Activity,2,76,79,53,31,241,0,7,12,15,8,42,283,OD
ODISHA,2006,Retired Person,0,0,0,2,16,18,0,0,0,0,1,1,19,OD
ODISHA,2006,Total,43,741,870,493,226,2373,59,747,565,247,74,1692,4065,OD
ODISHA,2006,Total Salaried,0,59,75,42,7,183,0,49,42,23,0,114,297,OD
ODISHA,2006,Total Self-employed,15,359,496,329,135,1334,21,179,180,111,37,528,1862,OD
PUDUCHERRY,2006,Others (Please Specify),0,2,4,4,2,12,0,0,0,0,0,0,12,PY
PUDUCHERRY,2006,House Wife,0,0,0,0,0,0,0,47,31,10,8,96,96,PY
PUDUCHERRY,2006,Service (Government),0,1,9,7,0,17,0,1,2,0,0,3,20,PY
PUDUCHERRY,2006,Service (Private),0,18,29,15,2,64,0,5,2,0,0,7,71,PY
PUDUCHERRY,2006,Public Sector Undertaking,0,0,1,2,1,4,0,0,0,0,0,0,4,PY
PUDUCHERRY,2006,Student,5,10,0,0,0,15,8,29,0,0,0,37,52,PY
PUDUCHERRY,2006,Unemployed,0,14,8,9,14,45,0,20,1,2,5,28,73,PY
PUDUCHERRY,2006,Self-employed (Business activity),0,4,10,6,1,21,0,0,0,0,0,0,21,PY
PUDUCHERRY,2006,Professional Activity,0,0,0,0,0,0,0,0,0,0,0,0,0,PY
PUDUCHERRY,2006,Farming/Agriculture Activity,0,35,76,50,8,169,0,1,2,3,0,6,175,PY
PUDUCHERRY,2006,Retired Person,0,0,0,0,2,2,0,0,0,0,0,0,2,PY
PUDUCHERRY,2006,Total,5,84,137,93,30,349,8,103,38,15,13,177,526,PY
PUDUCHERRY,2006,Total Salaried,0,19,39,24,3,85,0,6,4,0,0,10,95,PY
PUDUCHERRY,2006,Total Self-employed,0,39,87,56,9,191,0,1,2,3,0,6,197,PY
PUNJAB,2006,Others (Please Specify),9,92,106,63,23,293,13,13,3,1,2,32,325,PN
PUNJAB,2006,House Wife,0,0,0,0,0,0,1,49,45,15,0,110,110,PN
PUNJAB,2006,Service (Government),0,5,7,4,0,16,0,0,0,0,0,0,16,PN
PUNJAB,2006,Service (Private),0,23,25,7,1,56,0,3,1,0,0,4,60,PN
PUNJAB,2006,Public Sector Undertaking,0,1,2,2,0,5,0,1,0,0,0,1,6,PN
PUNJAB,2006,Student,2,15,1,0,0,18,2,11,0,0,0,13,31,PN
PUNJAB,2006,Unemployed,0,29,22,8,7,66,0,2,0,0,0,2,68,PN
PUNJAB,2006,Self-employed (Business activity),0,6,10,6,1,23,0,0,0,0,0,0,23,PN
PUNJAB,2006,Professional Activity,0,18,10,12,7,47,0,0,0,0,0,0,47,PN
PUNJAB,2006,Farming/Agriculture Activity,0,27,28,22,8,85,0,0,0,0,0,0,85,PN
PUNJAB,2006,Retired Person,0,0,0,0,1,1,0,0,0,0,0,0,1,PN
PUNJAB,2006,Total,11,216,211,124,48,610,16,79,49,16,2,162,772,PN
PUNJAB,2006,Total Salaried,0,29,34,13,1,77,0,4,1,0,0,5,82,PN
PUNJAB,2006,Total Self-employed,3,89,95,68,21,276,1,6,2,0,0,9,285,PN
RAJASTHAN,2006,Others (Please Specify),42,516,729,393,108,1788,22,44,28,31,11,136,1924,RJ
RAJASTHAN,2006,House Wife,0,0,0,0,0,0,9,487,415,151,31,1093,1093,RJ
RAJASTHAN,2006,Service (Government),0,5,21,14,0,40,0,0,0,0,0,0,40,RJ
RAJASTHAN,2006,Service (Private),0,119,153,65,1,338,0,6,5,0,0,11,349,RJ
RAJASTHAN,2006,Public Sector Undertaking,0,13,11,5,0,29,0,2,2,0,0,4,33,RJ
RAJASTHAN,2006,Student,15,53,2,0,0,70,15,49,0,0,0,64,134,RJ
RAJASTHAN,2006,Unemployed,0,59,23,14,1,97,0,0,0,0,0,0,97,RJ
RAJASTHAN,2006,Self-employed (Business activity),0,58,78,32,3,171,0,5,0,0,0,5,176,RJ
RAJASTHAN,2006,Professional Activity,0,8,8,3,0,19,0,0,0,0,0,0,19,RJ
RAJASTHAN,2006,Farming/Agriculture Activity,2,85,147,101,21,356,0,16,18,4,1,39,395,RJ
RAJASTHAN,2006,Retired Person,0,0,0,2,0,2,0,0,1,0,0,1,3,RJ
RAJASTHAN,2006,Total,59,916,1172,629,134,2910,46,609,469,186,43,1353,4263,RJ
RAJASTHAN,2006,Total Salaried,0,137,185,84,1,407,0,8,7,0,0,15,422,RJ
RAJASTHAN,2006,Total Self-employed,4,379,539,272,57,1251,6,47,31,13,2,99,1350,RJ
SIKKIM,2006,Others (Please Specify),0,9,0,0,0,9,0,8,0,0,0,8,17,SK
SIKKIM,2006,House Wife,0,0,0,0,0,0,0,0,10,1,4,15,15,SK
SIKKIM,2006,Service (Government),0,4,0,0,0,4,0,0,0,0,0,0,4,SK
SIKKIM,2006,Service (Private),0,6,5,2,0,13,0,0,1,0,0,1,14,SK
SIKKIM,2006,Public Sector Undertaking,0,0,0,0,0,0,0,0,0,0,0,0,0,SK
SIKKIM,2006,Student,4,20,0,0,0,24,3,10,2,0,0,15,39,SK
SIKKIM,2006,Unemployed,0,0,10,8,0,18,0,0,0,0,0,0,18,SK
SIKKIM,2006,Self-employed (Business activity),0,0,3,0,0,3,0,0,0,0,0,0,3,SK
SIKKIM,2006,Professional Activity,0,0,0,0,0,0,0,0,0,0,0,0,0,SK
SIKKIM,2006,Farming/Agriculture Activity,0,10,13,4,0,27,0,8,0,0,0,8,35,SK
SIKKIM,2006,Retired Person,0,0,0,0,0,0,0,0,0,0,0,0,0,SK
SIKKIM,2006,Total,4,49,31,14,0,98,3,26,13,1,4,47,145,SK
SIKKIM,2006,Total Salaried,0,10,5,2,0,17,0,0,1,0,0,1,18,SK
SIKKIM,2006,Total Self-employed,0,19,16,4,0,39,0,16,0,0,0,16,55,SK
TAMIL NADU,2006,Others (Please Specify),0,1006,1102,1103,414,3625,44,323,309,187,117,980,4605,TN
TAMIL NADU,2006,House Wife,0,0,0,0,0,0,0,830,947,451,126,2354,2354,TN
TAMIL NADU,2006,Service (Government),0,20,89,45,1,155,0,10,8,7,5,30,185,TN
TAMIL NADU,2006,Service (Private),0,279,449,291,73,1092,0,462,101,58,7,628,1720,TN
TAMIL NADU,2006,Public Sector Undertaking,0,49,107,60,29,245,0,15,11,59,1,86,331,TN
TAMIL NADU,2006,Student,26,65,8,0,0,99,36,84,7,0,0,127,226,TN
TAMIL NADU,2006,Unemployed,0,364,116,170,96,746,0,240,122,86,33,481,1227,TN
TAMIL NADU,2006,Self-employed (Business activity),0,135,779,174,30,1118,0,8,76,3,0,87,1205,TN
TAMIL NADU,2006,Professional Activity,0,0,0,0,0,0,0,0,0,0,0,0,0,TN
TAMIL NADU,2006,Farming/Agriculture Activity,0,78,147,82,35,342,0,23,40,19,2,84,426,TN
TAMIL NADU,2006,Retired Person,0,0,0,10,77,87,0,0,0,0,15,15,102,TN
TAMIL NADU,2006,Total,26,1996,2797,1935,755,7509,80,1995,1621,870,306,4872,12381,TN
TAMIL NADU,2006,Total Salaried,0,348,645,396,103,1492,0,487,120,124,13,744,2236,TN
TAMIL NADU,2006,Total Self-employed,0,970,1626,1078,346,4020,0,255,296,129,72,752,4772,TN
TRIPURA,2006,Others (Please Specify),7,89,106,60,23,285,4,52,63,24,3,146,431,TR
TRIPURA,2006,House Wife,0,0,0,0,0,0,0,72,48,10,3,133,133,TR
TRIPURA,2006,Service (Government),0,1,5,4,0,10,0,0,0,0,0,0,10,TR
TRIPURA,2006,Service (Private),0,2,3,2,0,7,0,0,0,0,0,0,7,TR
TRIPURA,2006,Public Sector Undertaking,0,2,2,2,0,6,0,0,0,0,0,0,6,TR
TRIPURA,2006,Student,4,27,12,0,0,43,7,31,3,0,0,41,84,TR
TRIPURA,2006,Unemployed,0,19,23,3,0,45,0,13,4,0,0,17,62,TR
TRIPURA,2006,Self-employed (Business activity),0,2,7,5,4,18,0,0,0,0,0,0,18,TR
TRIPURA,2006,Professional Activity,0,3,4,0,0,7,0,0,0,0,0,0,7,TR
TRIPURA,2006,Farming/Agriculture Activity,0,0,5,2,0,7,0,0,0,0,0,0,7,TR
TRIPURA,2006,Retired Person,0,0,0,0,0,0,0,0,0,0,0,0,0,TR
TRIPURA,2006,Total,11,145,167,78,27,428,11,168,118,34,6,337,765,TR
TRIPURA,2006,Total Salaried,0,5,10,8,0,23,0,0,0,0,0,0,23,TR
TRIPURA,2006,Total Self-employed,2,12,38,17,10,79,0,3,2,1,0,6,85,TR
UTTAR PRADESH,2006,Others (Please Specify),47,141,245,114,41,588,35,112,86,51,24,308,896,UP
UTTAR PRADESH,2006,House Wife,0,0,0,0,0,0,8,446,186,39,31,710,710,UP
UTTAR PRADESH,2006,Service (Government),0,52,34,20,9,115,0,13,8,8,3,32,147,UP
UTTAR PRADESH,2006,Service (Private),2,79,53,18,3,155,0,27,28,3,0,58,213,UP
UTTAR PRADESH,2006,Public Sector Undertaking,0,9,15,4,0,28,0,13,5,1,0,19,47,UP
UTTAR PRADESH,2006,Student,14,88,0,0,0,102,5,62,2,0,0,69,171,UP
UTTAR PRADESH,2006,Unemployed,1,58,116,17,9,201,0,24,14,1,1,40,241,UP
UTTAR PRADESH,2006,Self-employed (Business activity),0,44,40,36,29,149,0,7,8,3,2,20,169,UP
UTTAR PRADESH,2006,Professional Activity,0,33,20,14,3,70,0,6,3,8,0,17,87,UP
UTTAR PRADESH,2006,Farming/Agriculture Activity,1,125,150,49,21,346,6,27,22,6,4,65,411,UP
UTTAR PRADESH,2006,Retired Person,0,0,0,4,3,7,0,0,0,0,0,0,7,UP
UTTAR PRADESH,2006,Total,65,629,673,276,118,1761,54,737,362,120,65,1338,3099,UP
UTTAR PRADESH,2006,Total Salaried,2,140,102,42,12,298,0,53,41,12,3,109,407,UP
UTTAR PRADESH,2006,Total Self-employed,37,327,312,162,73,911,30,109,104,42,15,300,1211,UP
UTTARAKHAND,2006,Others (Please Specify),0,17,21,8,3,49,4,7,2,0,0,13,62,UK
UTTARAKHAND,2006,House Wife,0,0,0,0,0,0,0,43,33,8,2,86,86,UK
UTTARAKHAND,2006,Service (Government),0,4,7,2,0,13,0,0,0,1,0,1,14,UK
UTTARAKHAND,2006,Service (Private),0,4,9,4,1,18,0,3,4,1,1,9,27,UK
UTTARAKHAND,2006,Public Sector Undertaking,0,1,3,2,0,6,0,3,2,1,0,6,12,UK
UTTARAKHAND,2006,Student,0,4,0,0,0,4,1,6,3,0,0,10,14,UK
UTTARAKHAND,2006,Unemployed,0,6,6,5,2,19,0,2,2,1,0,5,24,UK
UTTARAKHAND,2006,Self-employed (Business activity),0,5,8,6,2,21,0,2,0,0,0,2,23,UK
UTTARAKHAND,2006,Professional Activity,0,0,4,2,0,6,0,2,1,0,0,3,9,UK
UTTARAKHAND,2006,Farming/Agriculture Activity,0,10,12,10,1,33,0,9,8,1,0,18,51,UK
UTTARAKHAND,2006,Retired Person,0,0,0,0,4,4,0,0,0,0,0,0,4,UK
UTTARAKHAND,2006,Total,0,51,70,39,13,173,5,77,55,13,3,153,326,UK
UTTARAKHAND,2006,Total Salaried,0,9,19,8,1,37,0,6,6,3,1,16,53,UK
UTTARAKHAND,2006,Total Self-employed,0,18,28,23,6,75,1,14,9,1,0,25,100,UK
WEST BENGAL,2006,Others (Please Specify),4,524,641,582,138,1889,0,79,35,19,163,296,2185,WB
WEST BENGAL,2006,House Wife,0,0,0,0,0,0,0,2263,1584,1111,62,5020,5020,WB
WEST BENGAL,2006,Service (Government),0,20,81,62,0,163,0,8,16,12,0,36,199,WB
WEST BENGAL,2006,Service (Private),0,93,339,256,0,688,0,36,65,29,0,130,818,WB
WEST BENGAL,2006,Public Sector Undertaking,0,265,388,123,0,776,0,33,25,21,0,79,855,WB
WEST BENGAL,2006,Student,146,491,2,0,0,639,184,317,1,0,0,502,1141,WB
WEST BENGAL,2006,Unemployed,0,928,639,0,0,1567,0,144,37,0,0,181,1748,WB
WEST BENGAL,2006,Self-employed (Business activity),0,338,688,335,39,1400,0,10,33,8,0,51,1451,WB
WEST BENGAL,2006,Professional Activity,0,182,242,279,35,738,0,23,12,3,0,38,776,WB
WEST BENGAL,2006,Farming/Agriculture Activity,0,196,455,256,56,963,0,85,105,31,5,226,1189,WB
WEST BENGAL,2006,Retired Person,0,0,0,0,297,297,0,0,0,0,46,46,343,WB
WEST BENGAL,2006,Total,150,3037,3475,1893,565,9120,184,2998,1913,1234,276,6605,15725,WB
WEST BENGAL,2006,Total Salaried,0,378,808,441,0,1627,0,77,106,62,0,245,1872,WB
WEST BENGAL,2006,Total Self-employed,0,1237,2012,1432,243,4924,0,196,184,60,163,603,5527,WB
A & N ISLANDS,2007,Others (Please Specify),0,1,6,8,2,17,2,9,0,0,0,11,28,AN
A & N ISLANDS,2007,House Wife,0,0,0,0,0,0,0,10,10,8,2,30,30,AN
A & N ISLANDS,2007,Service (Government),0,1,4,4,0,9,0,1,0,0,0,1,10,AN
A & N ISLANDS,2007,Service (Private),0,17,12,8,2,39,0,1,0,0,0,1,40,AN
A & N ISLANDS,2007,Public Sector Undertaking,0,0,0,0,0,0,0,0,0,0,0,0,0,AN
A & N ISLANDS,2007,Student,0,4,0,0,0,4,4,9,0,0,0,13,17,AN
A & N ISLANDS,2007,Unemployed,0,9,1,1,1,12,0,0,0,0,0,0,12,AN
A & N ISLANDS,2007,Self-employed (Business activity),0,0,0,0,0,0,0,0,0,0,0,0,0,AN
A & N ISLANDS,2007,Professional Activity,0,0,0,0,0,0,0,0,0,0,0,0,0,AN
A & N ISLANDS,2007,Farming/Agriculture Activity,0,4,3,5,4,16,0,0,0,0,0,0,16,AN
A & N ISLANDS,2007,Retired Person,0,0,0,1,2,3,0,0,0,0,0,0,3,AN
A & N ISLANDS,2007,Total,0,36,26,27,11,100,6,30,10,8,2,56,156,AN
A & N ISLANDS,2007,Total Salaried,0,18,16,12,2,48,0,2,0,0,0,2,50,AN
A & N ISLANDS,2007,Total Self-employed,0,4,5,9,5,23,0,0,0,0,0,0,23,AN
ANDHRA PRADESH,2007,Others (Please Specify),45,1435,1660,1053,542,4735,72,563,363,227,119,1344,6079,AP
ANDHRA PRADESH,2007,House Wife,0,0,0,0,0,0,0,1105,811,405,159,2480,2480,AP
ANDHRA PRADESH,2007,Service (Government),0,71,86,63,0,220,1,26,19,9,0,55,275,AP
ANDHRA PRADESH,2007,Service (Private),6,239,490,266,102,1103,3,41,105,72,49,270,1373,AP
ANDHRA PRADESH,2007,Public Sector Undertaking,0,46,99,62,3,210,4,8,13,4,0,29,239,AP
ANDHRA PRADESH,2007,Student,63,327,27,3,0,420,80,193,6,0,0,279,699,AP
ANDHRA PRADESH,2007,Unemployed,0,120,146,74,0,340,7,43,10,3,0,63,403,AP
ANDHRA PRADESH,2007,Self-employed (Business activity),0,262,374,249,40,925,0,16,16,22,1,55,980,AP
ANDHRA PRADESH,2007,Professional Activity,2,110,151,109,49,421,7,31,17,3,0,58,479,AP
ANDHRA PRADESH,2007,Farming/Agriculture Activity,5,325,620,421,137,1508,20,113,90,53,13,289,1797,AP
ANDHRA PRADESH,2007,Retired Person,0,1,7,4,55,67,0,0,0,6,5,11,78,AP
ANDHRA PRADESH,2007,Total,121,2936,3660,2304,928,9949,194,2139,1450,804,346,4933,14882,AP
ANDHRA PRADESH,2007,Total Salaried,6,356,675,391,105,1533,8,75,137,85,49,354,1887,AP
ANDHRA PRADESH,2007,Total Self-employed,16,1333,2058,1342,567,5316,59,443,289,204,75,1070,6386,AP
ARUNACHAL PRADESH,2007,Others (Please Specify),0,10,12,0,0,22,3,3,1,2,0,9,31,AR
ARUNACHAL PRADESH,2007,House Wife,0,0,0,0,0,0,0,2,8,0,0,10,10,AR
ARUNACHAL PRADESH,2007,Service (Government),0,0,5,4,0,9,0,0,0,0,0,0,9,AR
ARUNACHAL PRADESH,2007,Service (Private),0,10,5,2,1,18,0,1,0,0,0,1,19,AR
ARUNACHAL PRADESH,2007,Public Sector Undertaking,0,0,0,0,0,0,0,0,0,0,0,0,0,AR
ARUNACHAL PRADESH,2007,Student,1,2,0,0,0,3,2,6,0,0,0,8,11,AR
ARUNACHAL PRADESH,2007,Unemployed,1,11,12,1,0,25,0,1,1,0,0,2,27,AR
ARUNACHAL PRADESH,2007,Self-employed (Business activity),0,1,1,2,0,4,0,0,0,0,0,0,4,AR
ARUNACHAL PRADESH,2007,Professional Activity,0,1,0,0,0,1,0,0,0,0,0,0,1,AR
ARUNACHAL PRADESH,2007,Farming/Agriculture Activity,0,4,9,1,0,14,0,1,0,0,0,1,15,AR
ARUNACHAL PRADESH,2007,Retired Person,0,0,0,0,2,2,0,0,0,0,0,0,2,AR
ARUNACHAL PRADESH,2007,Total,2,39,44,10,3,98,5,14,10,2,0,31,129,AR
ARUNACHAL PRADESH,2007,Total Salaried,0,10,10,6,1,27,0,1,0,0,0,1,28,AR
ARUNACHAL PRADESH,2007,Total Self-employed,0,12,20,3,0,35,1,4,0,1,0,6,41,AR
ASSAM,2007,Others (Please Specify),9,354,348,283,44,1038,9,121,85,18,15,248,1286,AS
ASSAM,2007,House Wife,0,0,0,0,0,0,0,188,214,95,19,516,516,AS
ASSAM,2007,Service (Government),0,6,7,2,0,15,0,0,2,0,0,2,17,AS
ASSAM,2007,Service (Private),0,9,11,10,0,30,0,7,3,2,0,12,42,AS
ASSAM,2007,Public Sector Undertaking,0,13,52,8,1,74,0,9,8,2,0,19,93,AS
ASSAM,2007,Student,29,90,0,0,0,119,23,62,3,1,1,90,209,AS
ASSAM,2007,Unemployed,0,7,2,15,6,30,0,5,1,0,0,6,36,AS
ASSAM,2007,Self-employed (Business activity),0,105,182,88,2,377,1,35,13,2,0,51,428,AS
ASSAM,2007,Professional Activity,0,30,86,34,0,150,0,0,0,0,0,0,150,AS
ASSAM,2007,Farming/Agriculture Activity,0,90,111,67,8,276,0,0,2,0,0,2,278,AS
ASSAM,2007,Retired Person,0,0,0,0,7,7,0,0,0,0,0,0,7,AS
ASSAM,2007,Total,38,704,799,507,68,2116,33,427,331,120,35,946,3062,AS
ASSAM,2007,Total Salaried,0,28,70,20,1,119,0,16,13,4,0,33,152,AS
ASSAM,2007,Total Self-employed,1,525,658,422,34,1640,6,96,64,11,8,185,1825,AS
BIHAR,2007,Others (Please Specify),17,92,83,48,18,258,18,90,24,22,17,171,429,BR
BIHAR,2007,House Wife,0,0,0,0,0,0,0,63,73,29,6,171,171,BR
BIHAR,2007,Service (Government),0,2,2,4,0,8,0,0,0,0,0,0,8,BR
BIHAR,2007,Service (Private),0,12,9,15,0,36,0,0,0,0,0,0,36,BR
BIHAR,2007,Public Sector Undertaking,0,4,5,8,2,19,0,0,0,0,0,0,19,BR
BIHAR,2007,Student,14,34,7,1,0,56,26,32,1,0,0,59,115,BR
BIHAR,2007,Unemployed,0,36,12,14,3,65,0,9,10,0,0,19,84,BR
BIHAR,2007,Self-employed (Business activity),0,2,1,4,1,8,0,2,1,0,0,3,11,BR
BIHAR,2007,Professional Activity,1,1,0,1,0,3,0,0,0,0,0,0,3,BR
BIHAR,2007,Farming/Agriculture Activity,1,29,27,19,2,78,0,0,8,0,0,8,86,BR
BIHAR,2007,Retired Person,0,0,0,1,2,3,0,0,0,0,0,0,3,BR
BIHAR,2007,Total,33,212,146,115,28,534,44,196,117,51,23,431,965,BR
BIHAR,2007,Total Salaried,0,18,16,27,2,63,0,0,0,0,0,0,63,BR
BIHAR,2007,Total Self-employed,3,82,62,49,14,210,3,37,16,14,8,78,288,BR
CHANDIGARH,2007,Others (Please Specify),0,4,4,0,1,9,0,0,0,0,0,0,9,CH
CHANDIGARH,2007,House Wife,0,0,0,0,0,0,0,10,8,1,2,21,21,CH
CHANDIGARH,2007,Service (Government),0,0,3,1,0,4,0,1,0,0,0,1,5,CH
CHANDIGARH,2007,Service (Private),0,3,10,4,0,17,0,0,0,0,0,0,17,CH
CHANDIGARH,2007,Public Sector Undertaking,0,0,0,0,0,0,0,0,0,0,0,0,0,CH
CHANDIGARH,2007,Student,2,13,0,0,0,15,0,0,0,0,0,0,15,CH
CHANDIGARH,2007,Unemployed,0,6,2,2,0,10,0,0,0,0,0,0,10,CH
CHANDIGARH,2007,Self-employed (Business activity),0,0,2,1,0,3,0,0,0,0,0,0,3,CH
CHANDIGARH,2007,Professional Activity,0,0,0,0,0,0,0,0,0,0,0,0,0,CH
CHANDIGARH,2007,Farming/Agriculture Activity,0,0,0,0,0,0,0,0,0,0,0,0,0,CH
CHANDIGARH,2007,Retired Person,0,0,0,0,2,2,0,0,0,0,0,0,2,CH
CHANDIGARH,2007,Total,2,26,21,8,3,60,0,11,8,1,2,22,82,CH
CHANDIGARH,2007,Total Salaried,0,3,13,5,0,21,0,1,0,0,0,1,22,CH
CHANDIGARH,2007,Total Self-employed,0,2,5,1,0,8,0,0,0,0,0,0,8,CH
CHHATTISGARH,2007,Others (Please Specify),44,317,363,257,156,1137,24,71,86,45,24,250,1387,CG
CHHATTISGARH,2007,House Wife,0,0,0,0,0,0,3,423,270,106,46,848,848,CG
CHHATTISGARH,2007,Service (Government),0,9,12,13,0,34,0,1,3,0,0,4,38,CG
CHHATTISGARH,2007,Service (Private),0,74,83,51,5,213,0,9,9,2,0,20,233,CG
CHHATTISGARH,2007,Public Sector Undertaking,0,8,11,3,0,22,0,1,1,0,0,2,24,CG
CHHATTISGARH,2007,Student,32,94,46,0,0,172,26,78,3,0,0,107,279,CG
CHHATTISGARH,2007,Unemployed,0,119,43,11,4,177,1,9,4,0,0,14,191,CG
CHHATTISGARH,2007,Self-employed (Business activity),0,36,64,24,8,132,0,1,2,0,0,3,135,CG
CHHATTISGARH,2007,Professional Activity,0,31,43,18,11,103,0,2,2,1,1,6,109,CG
CHHATTISGARH,2007,Farming/Agriculture Activity,2,359,458,310,135,1264,5,136,96,78,14,329,1593,CG
CHHATTISGARH,2007,Retired Person,0,0,0,1,1,2,0,0,0,0,0,0,2,CG
CHHATTISGARH,2007,Total,78,1047,1123,688,320,3256,59,731,476,232,85,1583,4839,CG
CHHATTISGARH,2007,Total Salaried,0,91,106,67,5,269,0,11,13,2,0,26,295,CG
CHHATTISGARH,2007,Total Self-employed,4,557,716,491,241,2009,9,182,165,107,29,492,2501,CG
D & N HAVELI,2007,Others (Please Specify),0,2,0,0,0,2,0,0,0,0,0,0,2,DN
D & N HAVELI,2007,House Wife,0,0,0,0,0,0,0,15,8,4,1,28,28,DN
D & N HAVELI,2007,Service (Government),0,0,0,0,0,0,0,0,0,0,0,0,0,DN
D & N HAVELI,2007,Service (Private),0,4,4,0,0,8,0,0,0,0,0,0,8,DN
D & N HAVELI,2007,Public Sector Undertaking,0,0,0,0,0,0,0,0,0,0,0,0,0,DN
D & N HAVELI,2007,Student,0,3,0,0,0,3,0,4,0,0,0,4,7,DN
D & N HAVELI,2007,Unemployed,0,2,3,2,0,7,0,0,0,0,0,0,7,DN
D & N HAVELI,2007,Self-employed (Business activity),0,0,1,1,0,2,0,0,0,0,0,0,2,DN
D & N HAVELI,2007,Professional Activity,0,0,0,0,0,0,0,0,0,0,0,0,0,DN
D & N HAVELI,2007,Farming/Agriculture Activity,0,4,6,4,3,17,0,0,0,0,0,0,17,DN
D & N HAVELI,2007,Retired Person,0,0,0,0,5,5,0,0,0,0,0,0,5,DN
D & N HAVELI,2007,Total,0,15,14,7,8,44,0,19,8,4,1,32,76,DN
D & N HAVELI,2007,Total Salaried,0,4,4,0,0,8,0,0,0,0,0,0,8,DN
D & N HAVELI,2007,Total Self-employed,0,4,7,5,3,19,0,0,0,0,0,0,19,DN
DAMAN & DIU,2007,Others (Please Specify),0,0,0,0,0,0,0,3,0,0,0,3,3,DD
DAMAN & DIU,2007,House Wife,0,0,0,0,0,0,0,3,2,0,0,5,5,DD
DAMAN & DIU,2007,Service (Government),0,0,0,2,0,2,0,0,0,0,0,0,2,DD
DAMAN & DIU,2007,Service (Private),0,3,1,0,0,4,0,1,0,0,0,1,5,DD
DAMAN & DIU,2007,Public Sector Undertaking,0,0,0,0,0,0,0,0,0,0,0,0,0,DD
DAMAN & DIU,2007,Student,0,0,0,0,0,0,0,0,0,0,0,0,0,DD
DAMAN & DIU,2007,Unemployed,0,0,0,0,0,0,0,0,0,0,0,0,0,DD
DAMAN & DIU,2007,Self-employed (Business activity),0,0,0,0,0,0,0,0,0,0,0,0,0,DD
DAMAN & DIU,2007,Professional Activity,0,0,0,0,0,0,0,0,0,0,0,0,0,DD
DAMAN & DIU,2007,Farming/Agriculture Activity,0,0,0,0,0,0,0,0,0,0,0,0,0,DD
DAMAN & DIU,2007,Retired Person,0,0,0,0,0,0,0,0,0,0,0,0,0,DD
DAMAN & DIU,2007,Total,0,3,1,2,0,6,0,7,2,0,0,9,15,DD
DAMAN & DIU,2007,Total Salaried,0,3,1,2,0,6,0,1,0,0,0,1,7,DD
DAMAN & DIU,2007,Total Self-employed,0,0,0,0,0,0,0,0,0,0,0,0,0,DD
DELHI (UT),2007,Others (Please Specify),2,135,178,53,17,385,8,63,29,5,1,106,491,DL
DELHI (UT),2007,House Wife,0,0,0,0,0,0,0,158,86,12,7,263,263,DL
DELHI (UT),2007,Service (Government),0,6,15,3,0,24,0,3,1,0,0,4,28,DL
DELHI (UT),2007,Service (Private),1,100,90,25,3,219,0,22,6,1,0,29,248,DL
DELHI (UT),2007,Public Sector Undertaking,0,4,5,3,0,12,0,2,0,0,0,2,14,DL
DELHI (UT),2007,Student,9,61,5,0,0,75,7,53,0,0,0,60,135,DL
DELHI (UT),2007,Unemployed,1,108,70,18,5,202,0,44,6,0,0,50,252,DL
DELHI (UT),2007,Self-employed (Business activity),0,9,2,5,1,17,0,0,0,0,0,0,17,DL
DELHI (UT),2007,Professional Activity,0,3,0,1,0,4,0,1,0,0,0,1,5,DL
DELHI (UT),2007,Farming/Agriculture Activity,0,5,10,7,1,23,0,0,0,0,0,0,23,DL
DELHI (UT),2007,Retired Person,0,0,0,0,5,5,0,0,0,0,0,0,5,DL
DELHI (UT),2007,Total,13,431,375,115,32,966,15,346,128,18,8,515,1481,DL
DELHI (UT),2007,Total Salaried,1,110,110,31,3,255,0,27,7,1,0,35,290,DL
DELHI (UT),2007,Total Self-employed,0,67,83,35,8,193,0,26,7,0,0,33,226,DL
GOA,2007,Others (Please Specify),0,5,5,1,1,12,1,1,1,0,0,3,15,GA
GOA,2007,House Wife,0,0,0,0,0,0,0,24,20,11,4,59,59,GA
GOA,2007,Service (Government),0,0,2,1,0,3,0,0,1,2,0,3,6,GA
GOA,2007,Service (Private),0,19,23,11,2,55,0,7,1,1,0,9,64,GA
GOA,2007,Public Sector Undertaking,0,0,0,0,0,0,0,0,0,0,0,0,0,GA
GOA,2007,Student,1,10,3,0,0,14,1,3,0,0,0,4,18,GA
GOA,2007,Unemployed,0,16,29,15,7,67,0,12,2,0,0,14,81,GA
GOA,2007,Self-employed (Business activity),0,3,7,4,2,16,0,0,0,0,0,0,16,GA
GOA,2007,Professional Activity,0,1,0,0,0,1,0,0,0,0,0,0,1,GA
GOA,2007,Farming/Agriculture Activity,0,0,0,0,0,0,0,0,0,0,0,0,0,GA
GOA,2007,Retired Person,0,0,0,4,6,10,0,0,0,0,0,0,10,GA
GOA,2007,Total,1,54,69,36,18,178,2,47,25,14,4,92,270,GA
GOA,2007,Total Salaried,0,19,25,12,2,58,0,7,2,3,0,12,70,GA
GOA,2007,Total Self-employed,0,6,8,4,3,21,0,0,0,0,0,0,21,GA
GUJARAT,2007,Others (Please Specify),9,303,333,157,46,848,5,78,51,27,16,177,1025,GJ
GUJARAT,2007,House Wife,0,0,0,0,0,0,2,729,540,235,107,1613,1613,GJ
GUJARAT,2007,Service (Government),0,29,37,19,0,85,0,8,7,4,1,20,105,GJ
GUJARAT,2007,Service (Private),0,190,215,105,6,516,1,26,19,8,1,55,571,GJ
GUJARAT,2007,Public Sector Undertaking,0,37,59,42,2,140,0,7,7,1,0,15,155,GJ
GUJARAT,2007,Student,23,123,6,3,0,155,26,102,17,3,0,148,303,GJ
GUJARAT,2007,Unemployed,1,179,182,73,8,443,1,23,22,9,2,57,500,GJ
GUJARAT,2007,Self-employed (Business activity),0,69,110,80,11,270,0,4,2,0,0,6,276,GJ
GUJARAT,2007,Professional Activity,0,179,173,79,23,454,0,16,15,5,1,37,491,GJ
GUJARAT,2007,Farming/Agriculture Activity,0,60,128,81,20,289,0,12,8,5,3,28,317,GJ
GUJARAT,2007,Retired Person,0,20,23,34,98,175,0,7,0,14,28,49,224,GJ
GUJARAT,2007,Total,33,1189,1266,673,214,3375,35,1012,688,311,159,2205,5580,GJ
GUJARAT,2007,Total Salaried,0,256,311,166,8,741,1,41,33,13,2,90,831,GJ
GUJARAT,2007,Total Self-employed,2,503,643,341,78,1567,0,80,51,21,11,163,1730,GJ
HARYANA,2007,Others (Please Specify),18,225,304,151,57,755,4,45,33,19,6,107,862,HR
HARYANA,2007,House Wife,0,0,0,0,0,0,0,193,110,37,16,356,356,HR
HARYANA,2007,Service (Government),0,18,25,20,1,64,0,12,3,0,0,15,79,HR
HARYANA,2007,Service (Private),0,99,95,28,2,224,0,18,4,0,0,22,246,HR
HARYANA,2007,Public Sector Undertaking,0,29,42,4,0,75,0,5,6,1,0,12,87,HR
HARYANA,2007,Student,8,68,4,0,0,80,4,34,3,1,0,42,122,HR
HARYANA,2007,Unemployed,2,111,108,32,6,259,0,5,12,6,0,23,282,HR
HARYANA,2007,Self-employed (Business activity),0,24,30,23,9,86,0,0,1,1,0,2,88,HR
HARYANA,2007,Professional Activity,0,5,23,29,0,57,0,0,0,0,0,0,57,HR
HARYANA,2007,Farming/Agriculture Activity,0,68,63,37,11,179,0,0,0,0,0,0,179,HR
HARYANA,2007,Retired Person,0,13,26,16,18,73,0,1,0,0,1,2,75,HR
HARYANA,2007,Total,28,660,720,340,104,1852,8,313,172,65,23,581,2433,HR
HARYANA,2007,Total Salaried,0,146,162,52,3,363,0,35,13,1,0,49,412,HR
HARYANA,2007,Total Self-employed,1,147,153,113,29,443,1,10,24,7,2,44,487,HR
HIMACHAL PRADESH,2007,Others (Please Specify),0,37,35,12,21,105,0,16,18,4,11,49,154,HP
HIMACHAL PRADESH,2007,House Wife,0,0,0,0,0,0,0,31,16,5,4,56,56,HP
HIMACHAL PRADESH,2007,Service (Government),0,2,7,2,0,11,0,0,0,0,0,0,11,HP
HIMACHAL PRADESH,2007,Service (Private),0,18,21,6,1,46,0,1,2,1,0,4,50,HP
HIMACHAL PRADESH,2007,Public Sector Undertaking,0,4,3,4,1,12,0,1,2,0,0,3,15,HP
HIMACHAL PRADESH,2007,Student,2,11,0,0,0,13,0,20,2,0,0,22,35,HP
HIMACHAL PRADESH,2007,Unemployed,0,12,7,3,1,23,0,2,2,0,0,4,27,HP
HIMACHAL PRADESH,2007,Self-employed (Business activity),0,6,10,7,2,25,0,1,2,0,0,3,28,HP
HIMACHAL PRADESH,2007,Professional Activity,0,2,4,1,1,8,0,0,1,1,0,2,10,HP
HIMACHAL PRADESH,2007,Farming/Agriculture Activity,0,0,11,3,0,14,0,0,1,0,0,1,15,HP
HIMACHAL PRADESH,2007,Retired Person,0,0,0,0,1,1,0,0,0,0,0,0,1,HP
HIMACHAL PRADESH,2007,Total,2,92,98,38,28,258,0,72,46,11,15,144,402,HP
HIMACHAL PRADESH,2007,Total Salaried,0,24,31,12,2,69,0,2,4,1,0,7,76,HP
HIMACHAL PRADESH,2007,Total Self-employed,0,28,42,20,23,113,0,6,11,4,8,29,142,HP
JAMMU & KASHMIR,2007,Others (Please Specify),0,13,26,4,3,46,0,7,1,0,0,8,54,JK
JAMMU & KASHMIR,2007,House Wife,0,0,0,0,0,0,0,26,21,4,2,53,53,JK
JAMMU & KASHMIR,2007,Service (Government),0,5,6,1,0,12,0,1,1,0,0,2,14,JK
JAMMU & KASHMIR,2007,Service (Private),0,2,5,3,0,10,0,1,0,0,0,1,11,JK
JAMMU & KASHMIR,2007,Public Sector Undertaking,0,4,1,0,0,5,0,2,0,0,0,2,7,JK
JAMMU & KASHMIR,2007,Student,0,13,1,0,0,14,0,10,0,0,0,10,24,JK
JAMMU & KASHMIR,2007,Unemployed,0,16,5,4,0,25,0,3,0,0,0,3,28,JK
JAMMU & KASHMIR,2007,Self-employed (Business activity),0,1,1,1,0,3,0,0,0,0,0,0,3,JK
JAMMU & KASHMIR,2007,Professional Activity,0,2,1,0,0,3,0,0,0,0,0,0,3,JK
JAMMU & KASHMIR,2007,Farming/Agriculture Activity,0,9,10,9,3,31,0,1,1,0,0,2,33,JK
JAMMU & KASHMIR,2007,Retired Person,0,0,1,1,2,4,0,0,0,0,0,0,4,JK
JAMMU & KASHMIR,2007,Total,0,65,57,23,8,153,0,51,24,4,2,81,234,JK
JAMMU & KASHMIR,2007,Total Salaried,0,11,12,4,0,27,0,4,1,0,0,5,32,JK
JAMMU & KASHMIR,2007,Total Self-employed,0,16,23,10,4,53,0,2,1,0,0,3,56,JK
JHARKHAND,2007,Others (Please Specify),17,109,152,118,30,426,8,53,36,21,12,130,556,JH
JHARKHAND,2007,House Wife,0,0,0,0,0,0,3,87,77,30,8,205,205,JH
JHARKHAND,2007,Service (Government),0,6,5,6,2,19,0,0,0,1,0,1,20,JH
JHARKHAND,2007,Service (Private),4,28,36,9,3,80,0,0,4,0,0,4,84,JH
JHARKHAND,2007,Public Sector Undertaking,0,0,0,0,0,0,0,0,0,0,0,0,0,JH
JHARKHAND,2007,Student,24,33,10,0,0,67,10,23,2,0,0,35,102,JH
JHARKHAND,2007,Unemployed,0,40,26,12,1,79,0,8,8,0,0,16,95,JH
JHARKHAND,2007,Self-employed (Business activity),1,15,19,14,0,49,0,0,3,1,0,4,53,JH
JHARKHAND,2007,Professional Activity,0,2,27,10,1,40,0,0,2,0,0,2,42,JH
JHARKHAND,2007,Farming/Agriculture Activity,0,28,40,28,5,101,1,7,3,1,0,12,113,JH
JHARKHAND,2007,Retired Person,0,0,1,0,18,19,0,0,0,0,0,0,19,JH
JHARKHAND,2007,Total,46,261,316,197,60,880,22,178,135,54,20,409,1289,JH
JHARKHAND,2007,Total Salaried,4,34,41,15,5,99,0,0,4,1,0,5,104,JH
JHARKHAND,2007,Total Self-employed,1,67,110,73,11,262,2,29,26,8,2,67,329,JH
KARNATAKA,2007,Others (Please Specify),58,1005,1414,1176,359,4012,54,336,386,226,79,1081,5093,KA
KARNATAKA,2007,House Wife,0,0,0,0,0,0,1,656,611,382,152,1802,1802,KA
KARNATAKA,2007,Service (Government),0,58,53,67,1,179,0,11,9,5,3,28,207,KA
KARNATAKA,2007,Service (Private),0,273,332,248,49,902,1,114,36,18,5,174,1076,KA
KARNATAKA,2007,Public Sector Undertaking,0,54,68,36,18,176,0,9,9,9,0,27,203,KA
KARNATAKA,2007,Student,51,177,18,0,0,246,58,193,10,0,0,261,507,KA
KARNATAKA,2007,Unemployed,0,137,185,106,22,450,6,63,21,11,1,102,552,KA
KARNATAKA,2007,Self-employed (Business activity),0,102,176,123,20,421,0,26,24,11,2,63,484,KA
KARNATAKA,2007,Professional Activity,0,37,82,58,10,187,0,3,4,0,0,7,194,KA
KARNATAKA,2007,Farming/Agriculture Activity,0,311,655,595,211,1772,7,112,125,91,28,363,2135,KA
KARNATAKA,2007,Retired Person,0,0,1,10,36,47,0,0,0,0,4,4,51,KA
KARNATAKA,2007,Total,109,2154,2984,2419,726,8392,127,1523,1235,753,274,3912,12304,KA
KARNATAKA,2007,Total Salaried,0,385,453,351,68,1257,1,134,54,32,8,229,1486,KA
KARNATAKA,2007,Total Self-employed,18,964,1676,1446,409,4513,23,299,373,235,44,974,5487,KA
KERALA,2007,Others (Please Specify),15,576,964,1104,707,3366,9,85,151,115,153,513,3879,KL
KERALA,2007,House Wife,0,0,0,0,0,0,0,289,394,433,210,1326,1326,KL
KERALA,2007,Service (Government),0,2,34,52,0,88,0,0,5,6,0,11,99,KL
KERALA,2007,Service (Private),0,34,209,135,12,390,0,21,33,24,0,78,468,KL
KERALA,2007,Public Sector Undertaking,0,3,32,50,6,91,0,2,5,6,0,13,104,KL
KERALA,2007,Student,33,82,0,0,0,115,34,124,2,0,0,160,275,KL
KERALA,2007,Unemployed,0,209,325,135,3,672,0,72,66,28,8,174,846,KL
KERALA,2007,Self-employed (Business activity),0,51,136,200,39,426,0,0,1,6,0,7,433,KL
KERALA,2007,Professional Activity,0,38,79,69,8,194,0,4,3,4,1,12,206,KL
KERALA,2007,Farming/Agriculture Activity,0,102,290,508,258,1158,0,13,21,25,15,74,1232,KL
KERALA,2007,Retired Person,0,0,0,20,68,88,0,0,0,0,6,6,94,KL
KERALA,2007,Total,48,1097,2069,2273,1101,6588,43,610,681,647,393,2374,8962,KL
KERALA,2007,Total Salaried,0,39,275,237,18,569,0,23,43,36,0,102,671,KL
KERALA,2007,Total Self-employed,0,587,1167,1454,718,3926,4,82,120,111,101,418,4344,KL
LAKSHADWEEP,2007,Others (Please Specify),0,0,0,0,0,0,0,0,0,0,0,0,0,LD
LAKSHADWEEP,2007,House Wife,0,0,0,0,0,0,0,0,0,2,0,2,2,LD
LAKSHADWEEP,2007,Service (Government),0,0,1,0,0,1,0,0,0,0,0,0,1,LD
LAKSHADWEEP,2007,Service (Private),0,0,0,0,0,0,0,0,0,0,0,0,0,LD
LAKSHADWEEP,2007,Public Sector Undertaking,0,0,0,0,0,0,0,0,0,0,0,0,0,LD
LAKSHADWEEP,2007,Student,0,0,0,0,0,0,0,0,0,0,0,0,0,LD
LAKSHADWEEP,2007,Unemployed,0,0,0,0,0,0,0,0,0,0,0,0,0,LD
LAKSHADWEEP,2007,Self-employed (Business activity),0,0,0,0,0,0,0,0,0,0,0,0,0,LD
LAKSHADWEEP,2007,Professional Activity,0,0,0,0,0,0,0,0,0,0,0,0,0,LD
LAKSHADWEEP,2007,Farming/Agriculture Activity,0,0,0,0,0,0,0,0,0,0,0,0,0,LD
LAKSHADWEEP,2007,Retired Person,0,0,0,0,0,0,0,0,0,0,0,0,0,LD
LAKSHADWEEP,2007,Total,0,0,1,0,0,1,0,0,0,2,0,2,3,LD
LAKSHADWEEP,2007,Total Salaried,0,0,1,0,0,1,0,0,0,0,0,0,1,LD
LAKSHADWEEP,2007,Total Self-employed,0,0,0,0,0,0,0,0,0,0,0,0,0,LD
MADHYA PRADESH,2007,Others (Please Specify),20,364,362,213,105,1064,51,181,81,28,21,362,1426,MP
MADHYA PRADESH,2007,House Wife,0,0,0,0,0,0,17,1128,511,165,86,1907,1907,MP
MADHYA PRADESH,2007,Service (Government),0,20,18,31,1,70,0,8,6,1,2,17,87,MP
MADHYA PRADESH,2007,Service (Private),11,63,53,35,7,169,1,45,25,8,1,80,249,MP
MADHYA PRADESH,2007,Public Sector Undertaking,0,65,47,26,1,139,1,44,11,9,0,65,204,MP
MADHYA PRADESH,2007,Student,34,155,2,0,0,191,32,98,0,1,4,135,326,MP
MADHYA PRADESH,2007,Unemployed,2,124,81,37,14,258,0,21,7,0,0,28,286,MP
MADHYA PRADESH,2007,Self-employed (Business activity),0,110,116,73,13,312,0,33,17,2,1,53,365,MP
MADHYA PRADESH,2007,Professional Activity,0,75,62,33,12,182,0,11,1,0,0,12,194,MP
MADHYA PRADESH,2007,Farming/Agriculture Activity,26,335,376,223,105,1065,8,104,67,15,4,198,1263,MP
MADHYA PRADESH,2007,Retired Person,0,2,9,5,4,20,2,0,0,0,0,2,22,MP
MADHYA PRADESH,2007,Total,93,1313,1126,676,262,3470,112,1673,726,229,119,2859,6329,MP
MADHYA PRADESH,2007,Total Salaried,11,148,118,92,9,378,2,97,42,18,3,162,540,MP
MADHYA PRADESH,2007,Total Self-employed,29,762,771,458,196,2216,43,276,140,30,19,508,2724,MP
MAHARASHTRA,2007,Others (Please Specify),1,538,811,458,223,2031,1,105,64,33,12,215,2246,MH
MAHARASHTRA,2007,House Wife,0,0,0,0,0,0,4,1880,1031,410,238,3563,3563,MH
MAHARASHTRA,2007,Service (Government),0,41,90,78,2,211,0,11,3,1,0,15,226,MH
MAHARASHTRA,2007,Service (Private),0,444,616,356,36,1452,0,80,47,11,0,138,1590,MH
MAHARASHTRA,2007,Public Sector Undertaking,0,31,44,37,3,115,0,11,4,5,0,20,135,MH
MAHARASHTRA,2007,Student,41,355,8,0,0,404,69,319,1,0,0,389,793,MH
MAHARASHTRA,2007,Unemployed,0,429,355,162,32,978,0,51,7,2,1,61,1039,MH
MAHARASHTRA,2007,Self-employed (Business activity),0,108,194,104,28,434,0,3,6,1,0,10,444,MH
MAHARASHTRA,2007,Professional Activity,0,168,291,165,57,681,0,27,18,12,9,66,747,MH
MAHARASHTRA,2007,Farming/Agriculture Activity,0,908,1498,1038,524,3968,0,131,73,37,29,270,4238,MH
MAHARASHTRA,2007,Retired Person,0,0,1,27,118,146,0,0,7,3,7,17,163,MH
MAHARASHTRA,2007,Total,42,3022,3908,2425,1023,10420,74,2618,1261,515,296,4764,15184,MH
MAHARASHTRA,2007,Total Salaried,0,516,750,471,41,1778,0,102,54,17,0,173,1951,MH
MAHARASHTRA,2007,Total Self-employed,0,1717,2780,1760,825,7082,1,264,160,82,50,557,7639,MH
MANIPUR,2007,Others (Please Specify),0,1,3,0,0,4,0,0,0,0,0,0,4,MN
MANIPUR,2007,House Wife,0,0,0,0,0,0,0,3,5,1,0,9,9,MN
MANIPUR,2007,Service (Government),0,0,8,2,0,10,0,0,0,0,0,0,10,MN
MANIPUR,2007,Service (Private),0,0,0,0,0,0,0,0,0,0,0,0,0,MN
MANIPUR,2007,Public Sector Undertaking,0,0,0,0,0,0,0,0,0,0,0,0,0,MN
MANIPUR,2007,Student,1,4,0,0,0,5,0,1,0,0,0,1,6,MN
MANIPUR,2007,Unemployed,0,2,6,1,0,9,0,0,1,0,0,1,10,MN
MANIPUR,2007,Self-employed (Business activity),0,0,0,0,0,0,0,0,0,0,0,0,0,MN
MANIPUR,2007,Professional Activity,0,0,0,0,0,0,0,0,0,0,0,0,0,MN
MANIPUR,2007,Farming/Agriculture Activity,0,0,0,0,0,0,0,0,0,0,0,0,0,MN
MANIPUR,2007,Retired Person,0,0,0,0,0,0,0,0,0,0,0,0,0,MN
MANIPUR,2007,Total,1,7,17,3,0,28,0,4,6,1,0,11,39,MN
MANIPUR,2007,Total Salaried,0,0,8,2,0,10,0,0,0,0,0,0,10,MN
MANIPUR,2007,Total Self-employed,0,0,2,0,0,2,0,0,0,0,0,0,2,MN
MEGHALAYA,2007,Others (Please Specify),0,2,5,3,0,10,0,3,4,0,0,7,17,ML
MEGHALAYA,2007,House Wife,0,0,0,0,0,0,0,2,4,0,0,6,6,ML
MEGHALAYA,2007,Service (Government),0,3,2,1,0,6,0,1,0,0,0,1,7,ML
MEGHALAYA,2007,Service (Private),0,0,0,0,0,0,0,0,0,0,0,0,0,ML
MEGHALAYA,2007,Public Sector Undertaking,0,0,0,1,0,1,0,0,0,0,0,0,1,ML
MEGHALAYA,2007,Student,1,9,0,0,0,10,0,5,2,0,0,7,17,ML
MEGHALAYA,2007,Unemployed,0,3,6,0,1,10,0,2,0,0,0,2,12,ML
MEGHALAYA,2007,Self-employed (Business activity),0,4,4,1,0,9,0,0,0,0,0,0,9,ML
MEGHALAYA,2007,Professional Activity,0,0,0,0,0,0,0,0,0,0,0,0,0,ML
MEGHALAYA,2007,Farming/Agriculture Activity,0,7,4,1,2,14,0,2,2,0,0,4,18,ML
MEGHALAYA,2007,Retired Person,0,0,0,0,0,0,0,0,0,0,0,0,0,ML
MEGHALAYA,2007,Total,1,28,21,7,3,60,0,15,12,0,0,27,87,ML
MEGHALAYA,2007,Total Salaried,0,3,2,2,0,7,0,1,0,0,0,1,8,ML
MEGHALAYA,2007,Total Self-employed,0,11,11,5,2,29,0,2,3,0,0,5,34,ML
MIZORAM,2007,Others (Please Specify),1,9,8,2,2,22,0,1,2,0,0,3,25,MZ
MIZORAM,2007,House Wife,0,0,0,0,0,0,0,0,1,2,0,3,3,MZ
MIZORAM,2007,Service (Government),0,0,0,0,0,0,0,0,0,0,0,0,0,MZ
MIZORAM,2007,Service (Private),0,0,0,0,0,0,0,0,0,0,0,0,0,MZ
MIZORAM,2007,Public Sector Undertaking,0,0,0,0,0,0,0,0,0,0,0,0,0,MZ
MIZORAM,2007,Student,0,0,0,0,0,0,0,0,0,0,0,0,0,MZ
MIZORAM,2007,Unemployed,0,0,0,0,0,0,0,0,0,0,0,0,0,MZ
MIZORAM,2007,Self-employed (Business activity),0,0,0,0,0,0,0,0,0,0,0,0,0,MZ
MIZORAM,2007,Professional Activity,0,0,0,0,0,0,0,0,0,0,0,0,0,MZ
MIZORAM,2007,Farming/Agriculture Activity,0,0,0,0,0,0,0,0,0,0,0,0,0,MZ
MIZORAM,2007,Retired Person,0,0,0,0,0,0,0,0,0,0,0,0,0,MZ
MIZORAM,2007,Total,1,9,8,2,2,22,0,1,3,2,0,6,28,MZ
MIZORAM,2007,Total Salaried,0,0,0,0,0,0,0,0,0,0,0,0,0,MZ
MIZORAM,2007,Total Self-employed,0,0,0,0,0,0,0,0,0,0,0,0,0,MZ
NAGALAND,2007,Others (Please Specify),0,3,6,1,0,10,0,2,0,0,0,2,12,NG
NAGALAND,2007,House Wife,0,0,0,0,0,0,0,1,4,0,0,5,5,NG
NAGALAND,2007,Service (Government),0,1,0,4,0,5,0,0,0,0,0,0,5,NG
NAGALAND,2007,Service (Private),0,0,0,0,0,0,0,0,0,0,0,0,0,NG
NAGALAND,2007,Public Sector Undertaking,0,0,0,0,0,0,0,0,0,0,0,0,0,NG
NAGALAND,2007,Student,0,0,0,0,0,0,0,0,0,0,0,0,0,NG
NAGALAND,2007,Unemployed,0,0,2,0,0,2,0,0,0,0,0,0,2,NG
NAGALAND,2007,Self-employed (Business activity),0,0,0,0,0,0,0,0,0,0,0,0,0,NG
NAGALAND,2007,Professional Activity,0,0,0,0,0,0,0,0,0,0,0,0,0,NG
NAGALAND,2007,Farming/Agriculture Activity,0,0,0,0,0,0,0,0,0,0,0,0,0,NG
NAGALAND,2007,Retired Person,0,0,0,0,0,0,0,0,0,0,0,0,0,NG
NAGALAND,2007,Total,0,4,8,5,0,17,0,3,4,0,0,7,24,NG
NAGALAND,2007,Total Salaried,0,1,0,4,0,5,0,0,0,0,0,0,5,NG
NAGALAND,2007,Total Self-employed,0,1,3,0,0,4,0,1,0,0,0,1,5,NG
ODISHA,2007,Others (Please Specify),37,301,397,263,160,1158,38,315,191,114,37,695,1853,OD
ODISHA,2007,House Wife,0,0,0,0,0,0,0,322,212,66,14,614,614,OD
ODISHA,2007,Service (Government),0,6,8,12,0,26,0,1,5,0,0,6,32,OD
ODISHA,2007,Service (Private),0,82,82,48,2,214,0,26,31,29,3,89,303,OD
ODISHA,2007,Public Sector Undertaking,0,34,48,26,4,112,0,17,3,8,0,28,140,OD
ODISHA,2007,Student,26,109,0,0,0,135,24,75,0,0,0,99,234,OD
ODISHA,2007,Unemployed,12,98,62,40,12,224,5,93,73,5,1,177,401,OD
ODISHA,2007,Self-employed (Business activity),0,75,161,77,23,336,0,6,4,2,0,12,348,OD
ODISHA,2007,Professional Activity,0,29,29,21,3,82,0,6,16,3,0,25,107,OD
ODISHA,2007,Farming/Agriculture Activity,2,42,61,48,17,170,3,17,21,16,13,70,240,OD
ODISHA,2007,Retired Person,0,0,0,6,25,31,0,0,0,0,5,5,36,OD
ODISHA,2007,Total,77,776,848,541,246,2488,70,878,556,243,73,1820,4308,OD
ODISHA,2007,Total Salaried,0,122,138,86,6,352,0,44,39,37,3,123,475,OD
ODISHA,2007,Total Self-employed,28,355,477,288,124,1272,33,230,138,67,31,499,1771,OD
PUDUCHERRY,2007,Others (Please Specify),1,2,3,5,0,11,1,4,0,0,0,5,16,PY
PUDUCHERRY,2007,House Wife,0,0,0,0,0,0,0,48,20,4,6,78,78,PY
PUDUCHERRY,2007,Service (Government),0,0,4,6,0,10,0,3,1,0,0,4,14,PY
PUDUCHERRY,2007,Service (Private),0,6,10,4,0,20,0,3,4,1,0,8,28,PY
PUDUCHERRY,2007,Public Sector Undertaking,0,0,0,0,0,0,0,0,0,0,0,0,0,PY
PUDUCHERRY,2007,Student,1,8,0,0,0,9,5,14,4,0,1,24,33,PY
PUDUCHERRY,2007,Unemployed,0,22,28,9,9,68,0,39,17,2,5,63,131,PY
PUDUCHERRY,2007,Self-employed (Business activity),0,2,6,10,2,20,0,0,0,0,0,0,20,PY
PUDUCHERRY,2007,Professional Activity,0,0,0,0,0,0,0,0,0,0,0,0,0,PY
PUDUCHERRY,2007,Farming/Agriculture Activity,0,33,82,54,12,181,0,9,6,1,0,16,197,PY
PUDUCHERRY,2007,Retired Person,0,0,0,0,0,0,0,0,0,0,0,0,0,PY
PUDUCHERRY,2007,Total,2,73,133,88,23,319,6,120,52,8,12,198,517,PY
PUDUCHERRY,2007,Total Salaried,0,6,14,10,0,30,0,6,5,1,0,12,42,PY
PUDUCHERRY,2007,Total Self-employed,0,35,88,64,14,201,1,13,6,1,0,21,222,PY
PUNJAB,2007,Others (Please Specify),3,132,113,49,31,328,7,29,12,2,0,50,378,PN
PUNJAB,2007,House Wife,0,0,0,0,0,0,0,62,53,13,4,132,132,PN
PUNJAB,2007,Service (Government),0,9,9,9,0,27,0,1,1,1,0,3,30,PN
PUNJAB,2007,Service (Private),0,22,28,13,0,63,0,3,0,0,0,3,66,PN
PUNJAB,2007,Public Sector Undertaking,0,0,0,0,0,0,0,0,0,0,0,0,0,PN
PUNJAB,2007,Student,2,12,1,0,0,15,6,9,0,0,0,15,30,PN
PUNJAB,2007,Unemployed,0,22,7,7,6,42,0,7,2,0,0,9,51,PN
PUNJAB,2007,Self-employed (Business activity),0,9,17,12,4,42,0,0,0,0,0,0,42,PN
PUNJAB,2007,Professional Activity,0,9,9,4,1,23,0,1,0,0,0,1,24,PN
PUNJAB,2007,Farming/Agriculture Activity,0,21,32,19,14,86,0,0,1,1,0,2,88,PN
PUNJAB,2007,Retired Person,0,0,0,4,2,6,0,0,0,0,0,0,6,PN
PUNJAB,2007,Total,5,236,216,117,58,632,13,112,69,17,4,215,847,PN
PUNJAB,2007,Total Salaried,0,31,37,22,0,90,0,4,1,1,0,6,96,PN
PUNJAB,2007,Total Self-employed,0,107,111,67,36,321,2,13,1,1,0,17,338,PN
RAJASTHAN,2007,Others (Please Specify),41,568,550,323,92,1574,14,65,14,12,4,109,1683,RJ
RAJASTHAN,2007,House Wife,0,0,0,0,0,0,9,398,410,177,29,1023,1023,RJ
RAJASTHAN,2007,Service (Government),0,5,22,12,0,39,0,10,17,1,1,29,68,RJ
RAJASTHAN,2007,Service (Private),6,102,150,82,1,341,0,9,1,0,0,10,351,RJ
RAJASTHAN,2007,Public Sector Undertaking,0,11,7,6,0,24,0,5,0,0,0,5,29,RJ
RAJASTHAN,2007,Student,28,86,1,0,0,115,13,47,10,0,0,70,185,RJ
RAJASTHAN,2007,Unemployed,1,48,86,20,2,157,0,1,2,2,0,5,162,RJ
RAJASTHAN,2007,Self-employed (Business activity),0,72,120,84,3,279,0,0,0,0,0,0,279,RJ
RAJASTHAN,2007,Professional Activity,0,18,16,2,0,36,0,0,3,0,0,3,39,RJ
RAJASTHAN,2007,Farming/Agriculture Activity,2,153,229,176,29,589,0,9,9,10,1,29,618,RJ
RAJASTHAN,2007,Retired Person,0,0,0,0,0,0,0,0,0,0,0,0,0,RJ
RAJASTHAN,2007,Total,78,1063,1181,705,127,3154,36,544,466,202,35,1283,4437,RJ
RAJASTHAN,2007,Total Salaried,6,118,179,100,1,404,0,24,18,1,1,44,448,RJ
RAJASTHAN,2007,Total Self-employed,7,497,699,390,68,1661,0,34,21,17,1,73,1734,RJ
SIKKIM,2007,Others (Please Specify),3,26,13,2,2,46,7,5,4,4,0,20,66,SK
SIKKIM,2007,House Wife,0,0,0,0,0,0,0,6,0,0,0,6,6,SK
SIKKIM,2007,Service (Government),0,0,0,0,0,0,0,0,0,0,0,0,0,SK
SIKKIM,2007,Service (Private),0,3,3,3,0,9,0,3,0,0,0,3,12,SK
SIKKIM,2007,Public Sector Undertaking,0,0,0,0,0,0,0,1,0,0,0,1,1,SK
SIKKIM,2007,Student,2,3,0,0,0,5,0,0,0,0,0,0,5,SK
SIKKIM,2007,Unemployed,0,9,0,0,0,9,0,2,0,0,0,2,11,SK
SIKKIM,2007,Self-employed (Business activity),0,0,0,0,0,0,0,0,0,0,0,0,0,SK
SIKKIM,2007,Professional Activity,0,0,0,0,0,0,0,0,0,0,0,0,0,SK
SIKKIM,2007,Farming/Agriculture Activity,0,0,8,7,0,15,0,2,4,0,0,6,21,SK
SIKKIM,2007,Retired Person,0,0,0,0,0,0,0,0,0,0,0,0,0,SK
SIKKIM,2007,Total,5,41,24,12,2,84,7,19,8,4,0,38,122,SK
SIKKIM,2007,Total Salaried,0,3,3,3,0,9,0,4,0,0,0,4,13,SK
SIKKIM,2007,Total Self-employed,3,18,13,9,2,45,1,5,4,3,0,13,58,SK
TAMIL NADU,2007,Others (Please Specify),0,1165,1280,1273,476,4194,45,338,323,204,120,1030,5224,TN
TAMIL NADU,2007,House Wife,0,0,0,0,0,0,0,873,996,474,133,2476,2476,TN
TAMIL NADU,2007,Service (Government),0,23,103,52,1,179,0,10,9,8,5,32,211,TN
TAMIL NADU,2007,Service (Private),0,323,519,337,84,1263,0,486,106,61,7,660,1923,TN
TAMIL NADU,2007,Public Sector Undertaking,0,57,124,69,33,283,0,19,11,59,1,90,373,TN
TAMIL NADU,2007,Student,30,76,6,1,2,115,38,89,7,0,0,134,249,TN
TAMIL NADU,2007,Unemployed,0,421,134,197,111,863,0,253,128,90,35,506,1369,TN
TAMIL NADU,2007,Self-employed (Business activity),0,156,901,201,35,1293,0,9,80,3,0,92,1385,TN
TAMIL NADU,2007,Professional Activity,0,0,0,0,0,0,0,0,0,0,0,0,0,TN
TAMIL NADU,2007,Farming/Agriculture Activity,0,90,170,95,41,396,0,25,42,19,2,88,484,TN
TAMIL NADU,2007,Retired Person,0,0,0,12,89,101,0,0,0,0,16,16,117,TN
TAMIL NADU,2007,Total,30,2311,3237,2237,872,8687,83,2102,1702,918,319,5124,13811,TN
TAMIL NADU,2007,Total Salaried,0,403,746,458,118,1725,0,515,126,128,13,782,2507,TN
TAMIL NADU,2007,Total Self-employed,0,1122,1881,1247,401,4651,0,269,311,135,76,791,5442,TN
TRIPURA,2007,Others (Please Specify),12,94,64,64,7,241,6,44,66,32,3,151,392,TR
TRIPURA,2007,House Wife,0,0,0,0,0,0,0,49,31,9,4,93,93,TR
TRIPURA,2007,Service (Government),0,3,23,2,0,28,0,3,2,0,0,5,33,TR
TRIPURA,2007,Service (Private),0,2,6,0,0,8,0,0,0,0,0,0,8,TR
TRIPURA,2007,Public Sector Undertaking,0,0,0,0,0,0,0,0,0,0,0,0,0,TR
TRIPURA,2007,Student,14,22,0,0,0,36,16,18,0,0,0,34,70,TR
TRIPURA,2007,Unemployed,0,12,20,9,0,41,0,2,1,0,0,3,44,TR
TRIPURA,2007,Self-employed (Business activity),0,14,28,18,3,63,0,0,0,0,0,0,63,TR
TRIPURA,2007,Professional Activity,0,0,0,0,0,0,0,0,0,0,0,0,0,TR
TRIPURA,2007,Farming/Agriculture Activity,0,0,0,0,0,0,0,0,0,0,0,0,0,TR
TRIPURA,2007,Retired Person,0,1,0,1,0,2,0,0,0,0,0,0,2,TR
TRIPURA,2007,Total,26,148,141,94,10,419,22,116,100,41,7,286,705,TR
TRIPURA,2007,Total Salaried,0,5,29,2,0,36,0,3,2,0,0,5,41,TR
TRIPURA,2007,Total Self-employed,8,72,71,69,10,230,0,30,44,26,1,101,331,TR
UTTAR PRADESH,2007,Others (Please Specify),20,207,187,173,120,707,30,210,177,60,46,523,1230,UP
UTTAR PRADESH,2007,House Wife,0,0,0,0,0,0,10,560,312,67,25,974,974,UP
UTTAR PRADESH,2007,Service (Government),0,15,15,9,0,39,0,6,4,1,3,14,53,UP
UTTAR PRADESH,2007,Service (Private),3,72,83,28,5,191,0,26,12,4,1,43,234,UP
UTTAR PRADESH,2007,Public Sector Undertaking,0,10,11,9,3,33,1,8,4,0,0,13,46,UP
UTTAR PRADESH,2007,Student,18,123,7,0,0,148,20,96,8,0,2,126,274,UP
UTTAR PRADESH,2007,Unemployed,5,129,122,49,12,317,1,34,8,2,5,50,367,UP
UTTAR PRADESH,2007,Self-employed (Business activity),0,38,47,46,5,136,0,12,5,0,2,19,155,UP
UTTAR PRADESH,2007,Professional Activity,1,17,31,26,14,89,2,9,0,2,0,13,102,UP
UTTAR PRADESH,2007,Farming/Agriculture Activity,3,84,125,123,54,389,5,29,27,20,16,97,486,UP
UTTAR PRADESH,2007,Retired Person,0,0,0,2,3,5,0,0,0,0,1,1,6,UP
UTTAR PRADESH,2007,Total,50,695,628,465,216,2054,69,990,557,156,101,1873,3927,UP
UTTAR PRADESH,2007,Total Salaried,3,97,109,46,8,263,1,40,20,5,4,70,333,UP
UTTAR PRADESH,2007,Total Self-employed,14,300,335,330,148,1127,22,213,141,45,44,465,1592,UP
UTTARAKHAND,2007,Others (Please Specify),0,16,6,3,1,26,4,2,4,0,2,12,38,UK
UTTARAKHAND,2007,House Wife,0,0,0,0,0,0,0,40,19,6,2,67,67,UK
UTTARAKHAND,2007,Service (Government),0,1,4,0,0,5,0,2,0,0,0,2,7,UK
UTTARAKHAND,2007,Service (Private),0,8,14,4,0,26,0,3,2,0,0,5,31,UK
UTTARAKHAND,2007,Public Sector Undertaking,0,2,10,1,0,13,0,3,3,0,0,6,19,UK
UTTARAKHAND,2007,Student,1,5,2,0,0,8,3,4,0,0,0,7,15,UK
UTTARAKHAND,2007,Unemployed,1,8,8,3,0,20,1,2,3,0,0,6,26,UK
UTTARAKHAND,2007,Self-employed (Business activity),0,6,4,0,0,10,0,0,2,0,0,2,12,UK
UTTARAKHAND,2007,Professional Activity,0,0,3,1,0,4,0,1,0,0,0,1,5,UK
UTTARAKHAND,2007,Farming/Agriculture Activity,0,7,9,2,0,18,0,6,2,2,0,10,28,UK
UTTARAKHAND,2007,Retired Person,0,0,0,0,0,0,0,0,0,0,0,0,0,UK
UTTARAKHAND,2007,Total,2,53,60,14,1,130,8,63,35,8,4,118,248,UK
UTTARAKHAND,2007,Total Salaried,0,11,28,5,0,44,0,8,5,0,0,13,57,UK
UTTARAKHAND,2007,Total Self-employed,0,18,17,5,0,40,2,9,5,2,0,18,58,UK
WEST BENGAL,2007,Others (Please Specify),97,982,1197,746,285,3307,82,537,470,436,124,1649,4956,WB
WEST BENGAL,2007,House Wife,0,0,0,0,0,0,0,1541,1296,451,74,3362,3362,WB
WEST BENGAL,2007,Service (Government),0,23,48,43,2,116,0,3,8,13,0,24,140,WB
WEST BENGAL,2007,Service (Private),0,136,225,207,11,579,0,23,63,17,0,103,682,WB
WEST BENGAL,2007,Public Sector Undertaking,0,130,327,192,6,655,0,42,24,18,0,84,739,WB
WEST BENGAL,2007,Student,112,532,5,0,0,649,110,369,10,0,0,489,1138,WB
WEST BENGAL,2007,Unemployed,3,321,348,129,4,805,10,137,183,32,0,362,1167,WB
WEST BENGAL,2007,Self-employed (Business activity),0,312,506,316,24,1158,0,8,25,6,0,39,1197,WB
WEST BENGAL,2007,Professional Activity,0,22,118,122,1,263,0,2,1,0,0,3,266,WB
WEST BENGAL,2007,Farming/Agriculture Activity,5,188,432,185,68,878,0,68,98,40,18,224,1102,WB
WEST BENGAL,2007,Retired Person,0,0,0,0,95,95,0,0,0,0,16,16,111,WB
WEST BENGAL,2007,Total,217,2646,3206,1940,496,8505,202,2730,2178,1013,232,6355,14860,WB
WEST BENGAL,2007,Total Salaried,0,289,600,442,19,1350,0,68,95,48,0,211,1561,WB
WEST BENGAL,2007,Total Self-employed,66,1084,1880,1072,276,4378,38,327,413,304,68,1150,5528,WB
A & N ISLANDS,2008,Others (Please Specify),0,1,5,3,2,11,0,5,0,0,0,5,16,AN
A & N ISLANDS,2008,House Wife,0,0,0,0,0,0,0,10,13,5,4,32,32,AN
A & N ISLANDS,2008,Service (Government),0,2,2,3,0,7,0,0,0,0,0,0,7,AN
A & N ISLANDS,2008,Service (Private),0,17,15,8,3,43,0,1,0,0,0,1,44,AN
A & N ISLANDS,2008,Public Sector Undertaking,0,0,0,0,0,0,0,0,0,0,0,0,0,AN
A & N ISLANDS,2008,Student,0,4,0,0,0,4,0,7,0,0,0,7,11,AN
A & N ISLANDS,2008,Unemployed,0,2,1,0,2,5,0,0,0,0,0,0,5,AN
A & N ISLANDS,2008,Self-employed (Business activity),0,0,1,0,0,1,0,0,0,0,0,0,1,AN
A & N ISLANDS,2008,Professional Activity,0,0,0,0,0,0,0,0,0,0,0,0,0,AN
A & N ISLANDS,2008,Farming/Agriculture Activity,0,5,8,6,4,23,0,0,0,0,0,0,23,AN
A & N ISLANDS,2008,Retired Person,0,0,0,1,3,4,0,0,0,0,0,0,4,AN
A & N ISLANDS,2008,Total,0,31,32,21,14,98,0,23,13,5,4,45,143,AN
A & N ISLANDS,2008,Total Salaried,0,19,17,11,3,50,0,1,0,0,0,1,51,AN
A & N ISLANDS,2008,Total Self-employed,0,5,11,7,5,28,0,0,0,0,0,0,28,AN
ANDHRA PRADESH,2008,Others (Please Specify),46,1227,1494,896,307,3970,72,471,281,178,82,1084,5054,AP
ANDHRA PRADESH,2008,House Wife,0,0,0,0,0,0,0,984,1012,381,139,2516,2516,AP
ANDHRA PRADESH,2008,Service (Government),0,17,108,121,0,246,0,7,37,15,0,59,305,AP
ANDHRA PRADESH,2008,Service (Private),0,239,420,217,92,968,0,68,75,31,15,189,1157,AP
ANDHRA PRADESH,2008,Public Sector Undertaking,4,123,155,181,68,531,0,34,33,21,22,110,641,AP
ANDHRA PRADESH,2008,Student,37,233,19,5,0,294,44,133,9,1,0,187,481,AP
ANDHRA PRADESH,2008,Unemployed,0,185,164,170,0,519,0,7,20,25,0,52,571,AP
ANDHRA PRADESH,2008,Self-employed (Business activity),0,194,458,218,65,935,0,11,17,0,2,30,965,AP
ANDHRA PRADESH,2008,Professional Activity,2,60,202,157,38,459,0,25,4,0,4,33,492,AP
ANDHRA PRADESH,2008,Farming/Agriculture Activity,2,436,628,505,176,1747,6,142,91,84,35,358,2105,AP
ANDHRA PRADESH,2008,Retired Person,0,0,21,7,24,52,0,0,5,2,8,15,67,AP
ANDHRA PRADESH,2008,Total,91,2714,3669,2477,770,9721,122,1882,1584,738,307,4633,14354,AP
ANDHRA PRADESH,2008,Total Salaried,4,379,683,519,160,1745,0,109,145,67,37,358,2103,AP
ANDHRA PRADESH,2008,Total Self-employed,11,1251,2103,1307,425,5097,40,448,252,179,82,1001,6098,AP
ARUNACHAL PRADESH,2008,Others (Please Specify),1,19,2,0,0,22,0,10,1,0,0,11,33,AR
ARUNACHAL PRADESH,2008,House Wife,0,0,0,0,0,0,0,6,7,1,0,14,14,AR
ARUNACHAL PRADESH,2008,Service (Government),0,10,14,1,0,25,0,0,1,0,0,1,26,AR
ARUNACHAL PRADESH,2008,Service (Private),0,3,2,0,0,5,0,0,3,0,0,3,8,AR
ARUNACHAL PRADESH,2008,Public Sector Undertaking,0,0,0,0,0,0,0,0,0,0,0,0,0,AR
ARUNACHAL PRADESH,2008,Student,1,1,0,0,0,2,0,3,0,0,0,3,5,AR
ARUNACHAL PRADESH,2008,Unemployed,0,4,6,1,0,11,0,0,1,0,0,1,12,AR
ARUNACHAL PRADESH,2008,Self-employed (Business activity),0,0,0,0,0,0,0,0,0,0,0,0,0,AR
ARUNACHAL PRADESH,2008,Professional Activity,0,0,0,0,0,0,0,0,0,0,0,0,0,AR
ARUNACHAL PRADESH,2008,Farming/Agriculture Activity,0,6,1,5,0,12,0,0,0,0,0,0,12,AR
ARUNACHAL PRADESH,2008,Retired Person,0,0,0,0,0,0,0,0,0,0,0,0,0,AR
ARUNACHAL PRADESH,2008,Total,2,43,25,7,0,77,0,19,13,1,0,33,110,AR
ARUNACHAL PRADESH,2008,Total Salaried,0,13,16,1,0,30,0,0,4,0,0,4,34,AR
ARUNACHAL PRADESH,2008,Total Self-employed,0,25,2,5,0,32,0,10,1,0,0,11,43,AR
ASSAM,2008,Others (Please Specify),7,350,404,179,43,983,5,146,94,17,6,268,1251,AS
ASSAM,2008,House Wife,0,0,0,0,0,0,0,226,247,89,11,573,573,AS
ASSAM,2008,Service (Government),0,2,13,4,0,19,0,2,0,0,0,2,21,AS
ASSAM,2008,Service (Private),0,16,26,10,0,52,0,12,6,3,0,21,73,AS
ASSAM,2008,Public Sector Undertaking,0,5,28,13,0,46,0,5,1,1,0,7,53,AS
ASSAM,2008,Student,21,108,0,0,0,129,12,65,0,0,0,77,206,AS
ASSAM,2008,Unemployed,0,15,3,19,0,37,0,7,0,0,0,7,44,AS
ASSAM,2008,Self-employed (Business activity),0,117,171,86,1,375,0,35,8,10,1,54,429,AS
ASSAM,2008,Professional Activity,0,33,66,32,2,133,0,0,4,0,0,4,137,AS
ASSAM,2008,Farming/Agriculture Activity,0,70,61,55,6,192,0,5,0,0,0,5,197,AS
ASSAM,2008,Retired Person,0,0,0,0,4,4,0,0,0,0,1,1,5,AS
ASSAM,2008,Total,28,716,772,398,56,1970,17,503,360,120,19,1019,2989,AS
ASSAM,2008,Total Salaried,0,23,67,27,0,117,0,19,7,4,0,30,147,AS
ASSAM,2008,Total Self-employed,2,461,612,329,37,1441,1,112,49,19,5,186,1627,AS
BIHAR,2008,Others (Please Specify),24,124,135,51,41,375,29,69,53,21,15,187,562,BR
BIHAR,2008,House Wife,0,0,0,0,0,0,0,66,88,18,2,174,174,BR
BIHAR,2008,Service (Government),0,3,2,2,1,8,0,0,0,0,0,0,8,BR
BIHAR,2008,Service (Private),0,7,8,15,1,31,0,1,2,1,0,4,35,BR
BIHAR,2008,Public Sector Undertaking,0,10,2,1,0,13,0,9,1,0,0,10,23,BR
BIHAR,2008,Student,9,26,7,0,0,42,3,13,0,0,0,16,58,BR
BIHAR,2008,Unemployed,2,24,17,6,0,49,1,3,0,0,0,4,53,BR
BIHAR,2008,Self-employed (Business activity),0,8,7,0,0,15,0,0,0,0,0,0,15,BR
BIHAR,2008,Professional Activity,0,1,3,1,0,5,0,0,0,0,0,0,5,BR
BIHAR,2008,Farming/Agriculture Activity,0,15,21,21,5,62,0,4,1,0,0,5,67,BR
BIHAR,2008,Retired Person,0,0,0,0,9,9,0,0,0,0,6,6,15,BR
BIHAR,2008,Total,35,218,202,97,57,609,33,165,145,40,23,406,1015,BR
BIHAR,2008,Total Salaried,0,20,12,18,2,52,0,10,3,1,0,14,66,BR
BIHAR,2008,Total Self-employed,2,34,44,34,24,138,8,11,27,4,10,60,198,BR
CHANDIGARH,2008,Others (Please Specify),0,0,0,0,0,0,0,0,0,0,0,0,0,CH
CHANDIGARH,2008,House Wife,0,0,0,0,0,0,0,8,7,2,0,17,17,CH
CHANDIGARH,2008,Service (Government),0,0,2,1,0,3,0,0,0,0,0,0,3,CH
CHANDIGARH,2008,Service (Private),0,4,7,4,0,15,0,3,0,0,0,3,18,CH
CHANDIGARH,2008,Public Sector Undertaking,0,0,0,0,0,0,0,0,0,0,0,0,0,CH
CHANDIGARH,2008,Student,0,6,0,0,0,6,0,5,0,0,0,5,11,CH
CHANDIGARH,2008,Unemployed,0,10,7,6,0,23,0,0,0,0,0,0,23,CH
CHANDIGARH,2008,Self-employed (Business activity),0,2,3,3,0,8,0,0,0,0,0,0,8,CH
CHANDIGARH,2008,Professional Activity,0,0,0,1,0,1,0,0,0,0,0,0,1,CH
CHANDIGARH,2008,Farming/Agriculture Activity,0,0,0,0,0,0,0,0,0,0,0,0,0,CH
CHANDIGARH,2008,Retired Person,0,0,0,1,1,2,0,0,0,0,0,0,2,CH
CHANDIGARH,2008,Total,0,22,19,16,1,58,0,16,7,2,0,25,83,CH
CHANDIGARH,2008,Total Salaried,0,4,9,5,0,18,0,3,0,0,0,3,21,CH
CHANDIGARH,2008,Total Self-employed,0,2,3,4,0,9,0,0,0,0,0,0,9,CH
CHHATTISGARH,2008,Others (Please Specify),19,282,324,223,73,921,25,99,74,40,21,259,1180,CG
CHHATTISGARH,2008,House Wife,0,0,0,0,0,0,2,499,275,125,36,937,937,CG
CHHATTISGARH,2008,Service (Government),0,9,17,13,0,39,0,6,0,0,0,6,45,CG
CHHATTISGARH,2008,Service (Private),0,71,77,29,6,183,0,9,6,3,0,18,201,CG
CHHATTISGARH,2008,Public Sector Undertaking,0,1,6,3,0,10,0,0,0,0,0,0,10,CG
CHHATTISGARH,2008,Student,37,162,2,1,0,202,35,130,3,0,0,168,370,CG
CHHATTISGARH,2008,Unemployed,0,86,65,16,0,167,0,6,2,2,0,10,177,CG
CHHATTISGARH,2008,Self-employed (Business activity),0,51,63,33,6,153,0,4,0,0,0,4,157,CG
CHHATTISGARH,2008,Professional Activity,0,27,26,19,8,80,0,0,11,2,0,13,93,CG
CHHATTISGARH,2008,Farming/Agriculture Activity,9,436,576,346,124,1491,20,101,107,46,8,282,1773,CG
CHHATTISGARH,2008,Retired Person,0,0,0,2,0,2,0,0,0,0,0,0,2,CG
CHHATTISGARH,2008,Total,65,1125,1156,685,217,3248,82,854,478,218,65,1697,4945,CG
CHHATTISGARH,2008,Total Salaried,0,81,100,45,6,232,0,15,6,3,0,24,256,CG
CHHATTISGARH,2008,Total Self-employed,22,727,907,547,183,2386,31,187,163,65,17,463,2849,CG
D & N HAVELI,2008,Others (Please Specify),1,2,0,2,0,5,0,0,0,0,0,0,5,DN
D & N HAVELI,2008,House Wife,0,0,0,0,0,0,0,10,6,6,1,23,23,DN
D & N HAVELI,2008,Service (Government),0,0,0,1,0,1,0,0,0,0,0,0,1,DN
D & N HAVELI,2008,Service (Private),0,8,4,1,0,13,0,4,0,0,0,4,17,DN
D & N HAVELI,2008,Public Sector Undertaking,0,0,0,0,0,0,0,0,0,0,0,0,0,DN
D & N HAVELI,2008,Student,0,0,0,0,0,0,0,1,0,0,0,1,1,DN
D & N HAVELI,2008,Unemployed,0,0,0,0,0,0,0,0,0,0,0,0,0,DN
D & N HAVELI,2008,Self-employed (Business activity),0,0,1,0,0,1,0,0,0,0,0,0,1,DN
D & N HAVELI,2008,Professional Activity,0,0,0,0,0,0,0,0,0,0,0,0,0,DN
D & N HAVELI,2008,Farming/Agriculture Activity,0,1,6,4,1,12,0,0,0,0,0,0,12,DN
D & N HAVELI,2008,Retired Person,0,0,0,0,0,0,0,0,0,0,0,0,0,DN
D & N HAVELI,2008,Total,1,11,11,8,1,32,0,15,6,6,1,28,60,DN
D & N HAVELI,2008,Total Salaried,0,8,4,2,0,14,0,4,0,0,0,4,18,DN
D & N HAVELI,2008,Total Self-employed,0,1,7,4,1,13,0,0,0,0,0,0,13,DN
DAMAN & DIU,2008,Others (Please Specify),0,1,1,0,0,2,0,0,0,1,3,4,6,DD
DAMAN & DIU,2008,House Wife,0,0,0,0,0,0,0,0,0,0,0,0,0,DD
DAMAN & DIU,2008,Service (Government),0,0,0,1,0,1,0,0,0,0,0,0,1,DD
DAMAN & DIU,2008,Service (Private),0,3,3,2,0,8,0,0,0,0,0,0,8,DD
DAMAN & DIU,2008,Public Sector Undertaking,0,0,0,0,0,0,0,0,0,0,0,0,0,DD
DAMAN & DIU,2008,Student,0,0,0,0,0,0,0,0,0,0,0,0,0,DD
DAMAN & DIU,2008,Unemployed,0,0,0,2,0,2,0,1,0,0,0,1,3,DD
DAMAN & DIU,2008,Self-employed (Business activity),0,0,0,1,0,1,0,0,0,0,0,0,1,DD
DAMAN & DIU,2008,Professional Activity,0,0,0,0,0,0,0,0,0,0,0,0,0,DD
DAMAN & DIU,2008,Farming/Agriculture Activity,0,0,0,0,0,0,0,0,0,0,0,0,0,DD
DAMAN & DIU,2008,Retired Person,0,0,0,0,0,0,0,0,0,0,0,0,0,DD
DAMAN & DIU,2008,Total,0,4,4,6,0,14,0,1,0,1,3,5,19,DD
DAMAN & DIU,2008,Total Salaried,0,3,3,3,0,9,0,0,0,0,0,0,9,DD
DAMAN & DIU,2008,Total Self-employed,0,0,1,1,0,2,0,0,0,0,0,0,2,DD
DELHI (UT),2008,Others (Please Specify),2,101,82,34,9,228,3,45,8,3,1,60,288,DL
DELHI (UT),2008,House Wife,0,0,0,0,0,0,0,166,89,19,2,276,276,DL
DELHI (UT),2008,Service (Government),0,2,7,4,0,13,0,0,1,1,0,2,15,DL
DELHI (UT),2008,Service (Private),0,78,82,24,2,186,0,18,7,2,0,27,213,DL
DELHI (UT),2008,Public Sector Undertaking,0,16,12,3,4,35,0,3,0,0,0,3,38,DL
DELHI (UT),2008,Student,13,63,1,0,0,77,13,79,6,0,0,98,175,DL
DELHI (UT),2008,Unemployed,1,99,84,22,5,211,1,36,4,0,0,41,252,DL
DELHI (UT),2008,Self-employed (Business activity),0,7,10,4,0,21,0,0,0,0,0,0,21,DL
DELHI (UT),2008,Professional Activity,0,0,3,3,1,7,0,0,0,0,0,0,7,DL
DELHI (UT),2008,Farming/Agriculture Activity,0,5,5,2,3,15,1,0,0,0,0,1,16,DL
DELHI (UT),2008,Retired Person,0,0,0,1,1,2,0,0,0,0,0,0,2,DL
DELHI (UT),2008,Total,16,371,286,97,25,795,18,347,115,25,3,508,1303,DL
DELHI (UT),2008,Total Salaried,0,96,101,31,6,234,0,21,8,3,0,32,266,DL
DELHI (UT),2008,Total Self-employed,2,70,69,36,12,189,2,18,4,2,0,26,215,DL
GOA,2008,Others (Please Specify),0,8,24,5,8,45,0,5,1,0,0,6,51,GA
GOA,2008,House Wife,0,0,0,0,0,0,0,25,19,10,11,65,65,GA
GOA,2008,Service (Government),0,0,3,0,0,3,0,1,0,0,0,1,4,GA
GOA,2008,Service (Private),0,23,25,7,1,56,0,5,2,0,0,7,63,GA
GOA,2008,Public Sector Undertaking,0,0,0,0,0,0,0,0,0,0,0,0,0,GA
GOA,2008,Student,0,5,0,0,0,5,2,5,0,0,0,7,12,GA
GOA,2008,Unemployed,0,18,22,12,2,54,1,13,3,0,0,17,71,GA
GOA,2008,Self-employed (Business activity),0,1,7,3,0,11,0,0,1,0,0,1,12,GA
GOA,2008,Professional Activity,0,0,1,0,0,1,0,0,0,0,0,0,1,GA
GOA,2008,Farming/Agriculture Activity,0,0,2,2,2,6,0,0,0,0,0,0,6,GA
GOA,2008,Retired Person,0,0,0,0,2,2,0,0,0,0,0,0,2,GA
GOA,2008,Total,0,55,84,29,15,183,3,54,26,10,11,104,287,GA
GOA,2008,Total Salaried,0,23,28,7,1,59,0,6,2,0,0,8,67,GA
GOA,2008,Total Self-employed,0,2,13,5,6,26,0,1,1,0,0,2,28,GA
GUJARAT,2008,Others (Please Specify),11,355,397,247,64,1074,13,121,83,26,14,257,1331,GJ
GUJARAT,2008,House Wife,0,0,0,0,0,0,3,751,622,255,113,1744,1744,GJ
GUJARAT,2008,Service (Government),0,9,30,18,0,57,0,2,3,0,0,5,62,GJ
GUJARAT,2008,Service (Private),0,178,244,119,3,544,0,25,30,9,0,64,608,GJ
GUJARAT,2008,Public Sector Undertaking,0,23,55,22,2,102,0,16,7,2,0,25,127,GJ
GUJARAT,2008,Student,13,131,9,2,0,155,18,122,7,2,0,149,304,GJ
GUJARAT,2008,Unemployed,1,206,219,76,11,513,4,28,8,4,1,45,558,GJ
GUJARAT,2008,Self-employed (Business activity),0,75,124,78,10,287,0,0,3,0,0,3,290,GJ
GUJARAT,2008,Professional Activity,0,155,161,85,19,420,0,4,4,0,0,8,428,GJ
GUJARAT,2008,Farming/Agriculture Activity,0,115,182,92,52,441,1,21,19,38,6,85,526,GJ
GUJARAT,2008,Retired Person,0,3,1,48,90,142,0,0,0,11,34,45,187,GJ
GUJARAT,2008,Total,25,1250,1422,787,251,3735,39,1090,786,347,168,2430,6165,GJ
GUJARAT,2008,Total Salaried,0,210,329,159,5,703,0,43,40,11,0,94,797,GJ
GUJARAT,2008,Total Self-employed,2,570,708,388,107,1775,3,75,68,47,13,206,1981,GJ
HARYANA,2008,Others (Please Specify),37,335,416,176,92,1056,24,61,105,26,8,224,1280,HR
HARYANA,2008,House Wife,0,0,0,0,0,0,0,159,135,52,20,366,366,HR
HARYANA,2008,Service (Government),0,29,40,14,7,90,0,3,0,0,0,3,93,HR
HARYANA,2008,Service (Private),0,95,101,38,5,239,0,9,2,0,0,11,250,HR
HARYANA,2008,Public Sector Undertaking,0,41,33,11,7,92,0,3,1,0,0,4,96,HR
HARYANA,2008,Student,10,78,3,1,0,92,15,28,0,0,0,43,135,HR
HARYANA,2008,Unemployed,0,47,75,30,7,159,0,6,12,5,1,24,183,HR
HARYANA,2008,Self-employed (Business activity),0,15,16,7,0,38,0,3,0,0,0,3,41,HR
HARYANA,2008,Professional Activity,0,12,28,9,1,50,0,0,0,0,0,0,50,HR
HARYANA,2008,Farming/Agriculture Activity,0,34,62,36,18,150,0,0,0,0,0,0,150,HR
HARYANA,2008,Retired Person,0,1,0,0,7,8,0,2,0,2,0,4,12,HR
HARYANA,2008,Total,47,687,774,322,144,1974,39,274,255,85,29,682,2656,HR
HARYANA,2008,Total Salaried,0,165,174,63,19,421,0,15,3,0,0,18,439,HR
HARYANA,2008,Total Self-employed,0,103,163,70,25,361,0,12,8,4,0,24,385,HR
HIMACHAL PRADESH,2008,Others (Please Specify),0,31,26,36,8,101,2,23,9,4,0,38,139,HP
HIMACHAL PRADESH,2008,House Wife,0,0,0,0,0,0,0,38,29,11,9,87,87,HP
HIMACHAL PRADESH,2008,Service (Government),0,6,5,8,0,19,0,1,0,1,0,2,21,HP
HIMACHAL PRADESH,2008,Service (Private),0,20,10,8,1,39,0,3,5,1,1,10,49,HP
HIMACHAL PRADESH,2008,Public Sector Undertaking,0,6,5,4,1,16,0,4,1,2,0,7,23,HP
HIMACHAL PRADESH,2008,Student,3,17,0,0,0,20,5,10,0,1,0,16,36,HP
HIMACHAL PRADESH,2008,Unemployed,0,16,11,2,0,29,0,9,0,0,0,9,38,HP
HIMACHAL PRADESH,2008,Self-employed (Business activity),0,5,13,8,5,31,0,0,1,0,0,1,32,HP
HIMACHAL PRADESH,2008,Professional Activity,0,3,3,3,0,9,0,1,2,1,1,5,14,HP
HIMACHAL PRADESH,2008,Farming/Agriculture Activity,3,36,42,46,23,150,3,14,10,4,7,38,188,HP
HIMACHAL PRADESH,2008,Retired Person,0,0,0,1,2,3,0,0,0,0,0,0,3,HP
HIMACHAL PRADESH,2008,Total,6,140,115,116,40,417,10,103,57,25,18,213,630,HP
HIMACHAL PRADESH,2008,Total Salaried,0,32,20,20,2,74,0,8,6,4,1,19,93,HP
HIMACHAL PRADESH,2008,Total Self-employed,3,66,74,79,34,256,5,25,17,7,8,62,318,HP
JAMMU & KASHMIR,2008,Others (Please Specify),1,21,11,7,6,46,0,16,8,0,0,24,70,JK
JAMMU & KASHMIR,2008,House Wife,0,0,0,0,0,0,0,38,36,1,0,75,75,JK
JAMMU & KASHMIR,2008,Service (Government),0,4,12,9,0,25,0,1,2,0,0,3,28,JK
JAMMU & KASHMIR,2008,Service (Private),0,5,11,6,0,22,0,2,3,0,0,5,27,JK
JAMMU & KASHMIR,2008,Public Sector Undertaking,0,1,5,13,1,20,0,1,0,0,0,1,21,JK
JAMMU & KASHMIR,2008,Student,0,7,0,0,0,7,1,8,0,0,0,9,16,JK
JAMMU & KASHMIR,2008,Unemployed,0,16,19,1,1,37,0,12,2,0,0,14,51,JK
JAMMU & KASHMIR,2008,Self-employed (Business activity),0,0,3,2,1,6,0,0,0,0,0,0,6,JK
JAMMU & KASHMIR,2008,Professional Activity,0,0,1,2,1,4,0,0,0,0,0,0,4,JK
JAMMU & KASHMIR,2008,Farming/Agriculture Activity,0,2,1,1,0,4,0,2,0,0,0,2,6,JK
JAMMU & KASHMIR,2008,Retired Person,0,0,0,0,6,6,0,0,0,0,0,0,6,JK
JAMMU & KASHMIR,2008,Total,1,56,63,41,16,177,1,80,51,1,0,133,310,JK
JAMMU & KASHMIR,2008,Total Salaried,0,10,28,28,1,67,0,4,5,0,0,9,76,JK
JAMMU & KASHMIR,2008,Total Self-employed,0,13,11,8,5,37,0,11,3,0,0,14,51,JK
JHARKHAND,2008,Others (Please Specify),9,65,118,72,27,291,9,21,28,7,4,69,360,JH
JHARKHAND,2008,House Wife,0,0,0,0,0,0,1,58,67,41,3,170,170,JH
JHARKHAND,2008,Service (Government),0,2,7,3,0,12,0,0,0,1,0,1,13,JH
JHARKHAND,2008,Service (Private),0,8,19,4,0,31,0,0,4,0,0,4,35,JH
JHARKHAND,2008,Public Sector Undertaking,0,5,7,2,0,14,0,0,0,0,0,0,14,JH
JHARKHAND,2008,Student,8,52,1,0,0,61,13,26,1,0,0,40,101,JH
JHARKHAND,2008,Unemployed,0,17,18,10,5,50,1,3,6,0,0,10,60,JH
JHARKHAND,2008,Self-employed (Business activity),0,4,18,10,0,32,0,3,0,0,0,3,35,JH
JHARKHAND,2008,Professional Activity,0,1,32,10,0,43,5,0,0,0,0,5,48,JH
JHARKHAND,2008,Farming/Agriculture Activity,3,17,18,23,3,64,2,2,2,1,0,7,71,JH
JHARKHAND,2008,Retired Person,0,0,0,0,4,4,0,0,0,0,0,0,4,JH
JHARKHAND,2008,Total,20,171,238,134,39,602,31,113,108,50,7,309,911,JH
JHARKHAND,2008,Total Salaried,0,15,33,9,0,57,0,0,4,1,0,5,62,JH
JHARKHAND,2008,Total Self-employed,11,47,110,68,9,245,8,7,13,1,1,30,275,JH
KARNATAKA,2008,Others (Please Specify),30,1046,1294,1123,442,3935,44,462,416,285,141,1348,5283,KA
KARNATAKA,2008,House Wife,0,0,0,0,0,0,3,658,587,291,114,1653,1653,KA
KARNATAKA,2008,Service (Government),0,53,57,84,2,196,0,21,19,7,6,53,249,KA
KARNATAKA,2008,Service (Private),0,279,417,311,47,1054,5,120,50,15,22,212,1266,KA
KARNATAKA,2008,Public Sector Undertaking,0,60,77,75,23,235,1,46,6,10,6,69,304,KA
KARNATAKA,2008,Student,24,180,19,18,2,243,25,176,11,0,0,212,455,KA
KARNATAKA,2008,Unemployed,0,146,153,78,24,401,2,45,35,11,0,93,494,KA
KARNATAKA,2008,Self-employed (Business activity),0,149,248,115,32,544,0,13,14,9,4,40,584,KA
KARNATAKA,2008,Professional Activity,0,30,31,52,5,118,0,16,3,2,1,22,140,KA
KARNATAKA,2008,Farming/Agriculture Activity,0,255,570,435,179,1439,0,99,120,59,20,298,1737,KA
KARNATAKA,2008,Retired Person,0,0,4,12,35,51,0,1,0,1,4,6,57,KA
KARNATAKA,2008,Total,54,2198,2870,2303,791,8216,80,1657,1261,690,318,4006,12222,KA
KARNATAKA,2008,Total Salaried,0,392,551,470,72,1485,6,187,75,32,34,334,1819,KA
KARNATAKA,2008,Total Self-employed,11,829,1513,1179,483,4015,16,289,254,171,90,820,4835,KA
KERALA,2008,Others (Please Specify),1,572,1129,1112,635,3449,4,142,154,160,121,581,4030,KL
KERALA,2008,House Wife,0,0,0,0,0,0,0,258,435,376,251,1320,1320,KL
KERALA,2008,Service (Government),0,3,27,36,1,67,0,1,7,5,0,13,80,KL
KERALA,2008,Service (Private),0,52,176,147,14,389,0,23,28,25,1,77,466,KL
KERALA,2008,Public Sector Undertaking,0,4,35,37,0,76,0,3,4,3,0,10,86,KL
KERALA,2008,Student,25,66,0,0,0,91,38,157,0,0,0,195,286,KL
KERALA,2008,Unemployed,0,180,294,131,63,668,0,71,46,35,11,163,831,KL
KERALA,2008,Self-employed (Business activity),0,36,110,173,55,374,0,1,2,6,0,9,383,KL
KERALA,2008,Professional Activity,0,32,57,48,11,148,0,2,5,3,0,10,158,KL
KERALA,2008,Farming/Agriculture Activity,0,71,219,294,184,768,0,8,11,23,10,52,820,KL
KERALA,2008,Retired Person,0,0,1,23,76,100,0,0,0,1,8,9,109,KL
KERALA,2008,Total,26,1016,2048,2001,1039,6130,42,666,692,637,402,2439,8569,KL
KERALA,2008,Total Salaried,0,59,238,220,15,532,0,27,39,33,1,100,632,KL
KERALA,2008,Total Self-employed,0,467,960,1122,570,3119,1,106,117,122,57,403,3522,KL
LAKSHADWEEP,2008,Others (Please Specify),0,0,0,0,0,0,0,0,0,0,0,0,0,LD
LAKSHADWEEP,2008,House Wife,0,0,0,0,0,0,0,0,0,0,0,0,0,LD
LAKSHADWEEP,2008,Service (Government),0,0,0,0,0,0,0,0,0,0,0,0,0,LD
LAKSHADWEEP,2008,Service (Private),0,0,0,0,0,0,0,0,0,0,0,0,0,LD
LAKSHADWEEP,2008,Public Sector Undertaking,0,0,0,0,0,0,0,0,0,0,0,0,0,LD
LAKSHADWEEP,2008,Student,0,0,0,0,0,0,0,0,0,0,0,0,0,LD
LAKSHADWEEP,2008,Unemployed,0,0,0,0,0,0,0,0,0,0,0,0,0,LD
LAKSHADWEEP,2008,Self-employed (Business activity),0,0,0,0,0,0,0,0,0,0,0,0,0,LD
LAKSHADWEEP,2008,Professional Activity,0,0,0,0,0,0,0,0,0,0,0,0,0,LD
LAKSHADWEEP,2008,Farming/Agriculture Activity,0,0,0,0,0,0,0,0,0,0,0,0,0,LD
LAKSHADWEEP,2008,Retired Person,0,0,0,0,0,0,0,0,0,0,0,0,0,LD
LAKSHADWEEP,2008,Total,0,0,0,0,0,0,0,0,0,0,0,0,0,LD
LAKSHADWEEP,2008,Total Salaried,0,0,0,0,0,0,0,0,0,0,0,0,0,LD
LAKSHADWEEP,2008,Total Self-employed,0,0,0,0,0,0,0,0,0,0,0,0,0,LD
MADHYA PRADESH,2008,Others (Please Specify),34,400,491,282,193,1400,22,273,149,58,36,538,1938,MP
MADHYA PRADESH,2008,House Wife,0,0,0,0,0,0,6,1204,593,215,55,2073,2073,MP
MADHYA PRADESH,2008,Service (Government),0,60,66,56,0,182,0,22,26,0,0,48,230,MP
MADHYA PRADESH,2008,Service (Private),2,132,142,55,6,337,0,26,69,5,0,100,437,MP
MADHYA PRADESH,2008,Public Sector Undertaking,0,69,73,73,13,228,0,3,6,0,0,9,237,MP
MADHYA PRADESH,2008,Student,29,180,26,6,0,241,50,128,1,0,0,179,420,MP
MADHYA PRADESH,2008,Unemployed,1,146,78,48,5,278,0,38,15,0,0,53,331,MP
MADHYA PRADESH,2008,Self-employed (Business activity),1,103,148,43,12,307,0,14,8,2,0,24,331,MP
MADHYA PRADESH,2008,Professional Activity,2,62,86,48,4,202,0,19,10,4,0,33,235,MP
MADHYA PRADESH,2008,Farming/Agriculture Activity,6,437,389,204,136,1172,2,106,68,21,10,207,1379,MP
MADHYA PRADESH,2008,Retired Person,0,3,2,0,13,18,0,0,0,0,0,0,18,MP
MADHYA PRADESH,2008,Total,75,1592,1501,815,382,4365,80,1833,945,305,101,3264,7629,MP
MADHYA PRADESH,2008,Total Salaried,2,261,281,184,19,747,0,51,101,5,0,157,904,MP
MADHYA PRADESH,2008,Total Self-employed,30,852,931,501,312,2626,12,293,173,64,33,575,3201,MP
MAHARASHTRA,2008,Others (Please Specify),1,662,847,460,199,2169,7,114,61,44,15,241,2410,MH
MAHARASHTRA,2008,House Wife,0,0,0,0,0,0,7,1744,1017,369,247,3384,3384,MH
MAHARASHTRA,2008,Service (Government),0,28,61,58,0,147,0,6,4,0,0,10,157,MH
MAHARASHTRA,2008,Service (Private),0,476,693,360,31,1560,0,65,23,5,0,93,1653,MH
MAHARASHTRA,2008,Public Sector Undertaking,0,59,66,44,9,178,1,13,4,0,0,18,196,MH
MAHARASHTRA,2008,Student,44,355,8,0,0,407,57,290,3,0,0,350,757,MH
MAHARASHTRA,2008,Unemployed,2,353,284,134,23,796,0,56,19,1,1,77,873,MH
MAHARASHTRA,2008,Self-employed (Business activity),0,111,191,125,31,458,0,8,3,0,0,11,469,MH
MAHARASHTRA,2008,Professional Activity,0,136,183,111,51,481,0,27,24,6,2,59,540,MH
MAHARASHTRA,2008,Farming/Agriculture Activity,0,856,1392,935,390,3573,2,89,92,31,15,229,3802,MH
MAHARASHTRA,2008,Retired Person,0,0,0,20,100,120,0,0,1,2,10,13,133,MH
MAHARASHTRA,2008,Total,47,3036,3725,2247,834,9889,74,2412,1251,458,290,4485,14374,MH
MAHARASHTRA,2008,Total Salaried,0,563,820,462,40,1885,1,84,31,5,0,121,2006,MH
MAHARASHTRA,2008,Total Self-employed,0,1726,2544,1589,653,6512,3,229,175,80,31,518,7030,MH
MANIPUR,2008,Others (Please Specify),0,1,4,0,0,5,0,1,0,0,0,1,6,MN
MANIPUR,2008,House Wife,0,0,0,0,0,0,0,3,1,1,0,5,5,MN
MANIPUR,2008,Service (Government),0,3,4,0,0,7,0,0,0,0,0,0,7,MN
MANIPUR,2008,Service (Private),0,0,0,0,0,0,0,0,0,0,0,0,0,MN
MANIPUR,2008,Public Sector Undertaking,0,0,0,0,0,0,0,0,0,0,0,0,0,MN
MANIPUR,2008,Student,0,2,0,0,0,2,1,1,0,0,0,2,4,MN
MANIPUR,2008,Unemployed,0,5,2,0,0,7,0,2,1,0,0,3,10,MN
MANIPUR,2008,Self-employed (Business activity),0,0,0,0,0,0,0,0,0,0,0,0,0,MN
MANIPUR,2008,Professional Activity,0,0,0,0,0,0,0,0,0,0,0,0,0,MN
MANIPUR,2008,Farming/Agriculture Activity,0,0,2,0,0,2,0,0,0,0,0,0,2,MN
MANIPUR,2008,Retired Person,0,0,0,0,0,0,0,0,0,0,0,0,0,MN
MANIPUR,2008,Total,0,11,12,0,0,23,1,7,2,1,0,11,34,MN
MANIPUR,2008,Total Salaried,0,3,4,0,0,7,0,0,0,0,0,0,7,MN
MANIPUR,2008,Total Self-employed,0,1,5,0,0,6,0,1,0,0,0,1,7,MN
MEGHALAYA,2008,Others (Please Specify),0,4,12,2,1,19,0,2,6,0,1,9,28,ML
MEGHALAYA,2008,House Wife,0,0,0,0,0,0,0,3,4,2,0,9,9,ML
MEGHALAYA,2008,Service (Government),0,0,5,2,0,7,0,0,1,0,0,1,8,ML
MEGHALAYA,2008,Service (Private),0,0,1,0,0,1,0,0,0,0,0,0,1,ML
MEGHALAYA,2008,Public Sector Undertaking,0,0,0,0,0,0,0,0,0,0,0,0,0,ML
MEGHALAYA,2008,Student,0,4,1,0,0,5,1,3,0,0,0,4,9,ML
MEGHALAYA,2008,Unemployed,0,7,5,4,0,16,0,2,1,0,1,4,20,ML
MEGHALAYA,2008,Self-employed (Business activity),0,0,0,0,0,0,0,0,0,0,0,0,0,ML
MEGHALAYA,2008,Professional Activity,0,0,0,0,0,0,0,1,0,0,0,1,1,ML
MEGHALAYA,2008,Farming/Agriculture Activity,0,4,3,2,0,9,0,0,0,0,0,0,9,ML
MEGHALAYA,2008,Retired Person,0,0,0,0,0,0,0,0,0,0,0,0,0,ML
MEGHALAYA,2008,Total,0,19,27,10,1,57,1,11,12,2,2,28,85,ML
MEGHALAYA,2008,Total Salaried,0,0,6,2,0,8,0,0,1,0,0,1,9,ML
MEGHALAYA,2008,Total Self-employed,0,8,15,4,1,28,0,2,0,0,1,3,31,ML
MIZORAM,2008,Others (Please Specify),0,9,13,7,0,29,0,2,1,1,0,4,33,MZ
MIZORAM,2008,House Wife,0,0,0,0,0,0,0,0,0,0,0,0,0,MZ
MIZORAM,2008,Service (Government),0,0,0,0,0,0,0,0,0,0,0,0,0,MZ
MIZORAM,2008,Service (Private),0,0,0,0,0,0,0,0,0,0,0,0,0,MZ
MIZORAM,2008,Public Sector Undertaking,0,0,0,0,0,0,0,0,0,0,0,0,0,MZ
MIZORAM,2008,Student,0,3,0,0,0,3,0,0,2,0,0,2,5,MZ
MIZORAM,2008,Unemployed,0,0,0,0,0,0,0,0,0,0,0,0,0,MZ
MIZORAM,2008,Self-employed (Business activity),0,0,3,0,0,3,0,0,0,0,0,0,3,MZ
MIZORAM,2008,Professional Activity,0,0,0,0,0,0,0,0,0,0,0,0,0,MZ
MIZORAM,2008,Farming/Agriculture Activity,0,0,0,0,0,0,0,0,0,0,0,0,0,MZ
MIZORAM,2008,Retired Person,0,0,0,0,0,0,0,0,0,0,0,0,0,MZ
MIZORAM,2008,Total,0,12,16,7,0,35,0,2,3,1,0,6,41,MZ
MIZORAM,2008,Total Salaried,0,0,0,0,0,0,0,0,0,0,0,0,0,MZ
MIZORAM,2008,Total Self-employed,0,0,3,1,0,4,0,0,1,0,0,1,5,MZ
NAGALAND,2008,Others (Please Specify),0,2,16,8,0,26,0,0,2,0,0,2,28,NG
NAGALAND,2008,House Wife,0,0,0,0,0,0,0,4,0,0,0,4,4,NG
NAGALAND,2008,Service (Government),0,0,4,0,0,4,0,1,0,0,0,1,5,NG
NAGALAND,2008,Service (Private),0,0,0,0,0,0,0,0,0,0,0,0,0,NG
NAGALAND,2008,Public Sector Undertaking,0,0,0,0,0,0,0,0,0,0,0,0,0,NG
NAGALAND,2008,Student,0,0,0,0,0,0,0,3,0,0,0,3,3,NG
NAGALAND,2008,Unemployed,0,0,0,0,0,0,0,0,0,0,0,0,0,NG
NAGALAND,2008,Self-employed (Business activity),0,0,0,0,0,0,0,0,0,0,0,0,0,NG
NAGALAND,2008,Professional Activity,0,0,0,0,0,0,0,0,0,0,0,0,0,NG
NAGALAND,2008,Farming/Agriculture Activity,0,0,0,2,0,2,0,0,0,0,0,0,2,NG
NAGALAND,2008,Retired Person,0,0,0,0,0,0,0,0,0,0,0,0,0,NG
NAGALAND,2008,Total,0,2,20,10,0,32,0,8,2,0,0,10,42,NG
NAGALAND,2008,Total Salaried,0,0,4,0,0,4,0,1,0,0,0,1,5,NG
NAGALAND,2008,Total Self-employed,0,2,6,4,0,12,0,0,0,0,0,0,12,NG
ODISHA,2008,Others (Please Specify),51,472,421,386,168,1498,26,252,242,122,51,693,2191,OD
ODISHA,2008,House Wife,0,0,0,0,0,0,0,250,259,113,57,679,679,OD
ODISHA,2008,Service (Government),0,0,2,7,0,9,0,9,2,2,0,13,22,OD
ODISHA,2008,Service (Private),2,77,117,68,8,272,3,43,35,4,2,87,359,OD
ODISHA,2008,Public Sector Undertaking,0,53,42,11,2,108,0,19,9,0,0,28,136,OD
ODISHA,2008,Student,27,95,9,0,0,131,23,60,3,0,0,86,217,OD
ODISHA,2008,Unemployed,26,201,124,91,8,450,3,71,28,8,0,110,560,OD
ODISHA,2008,Self-employed (Business activity),0,50,121,77,27,275,0,7,2,4,0,13,288,OD
ODISHA,2008,Professional Activity,1,19,84,19,8,131,0,8,6,2,2,18,149,OD
ODISHA,2008,Farming/Agriculture Activity,7,77,101,41,19,245,0,1,10,3,1,15,260,OD
ODISHA,2008,Retired Person,0,0,0,13,23,36,0,0,0,1,6,7,43,OD
ODISHA,2008,Total,114,1044,1021,713,263,3155,55,720,596,259,119,1749,4904,OD
ODISHA,2008,Total Salaried,2,130,161,86,10,389,3,71,46,6,2,128,517,OD
ODISHA,2008,Total Self-employed,31,513,537,383,168,1632,9,150,143,72,32,406,2038,OD
PUDUCHERRY,2008,Others (Please Specify),0,49,84,72,12,217,0,9,2,1,0,12,229,PY
PUDUCHERRY,2008,House Wife,0,0,0,0,0,0,0,45,32,8,12,97,97,PY
PUDUCHERRY,2008,Service (Government),0,3,2,4,0,9,0,2,3,0,1,6,15,PY
PUDUCHERRY,2008,Service (Private),0,2,3,3,1,9,0,2,0,0,0,2,11,PY
PUDUCHERRY,2008,Public Sector Undertaking,0,0,0,0,0,0,0,3,0,0,0,3,3,PY
PUDUCHERRY,2008,Student,2,10,3,0,0,15,0,9,0,0,0,9,24,PY
PUDUCHERRY,2008,Unemployed,0,22,18,9,13,62,0,33,8,0,0,41,103,PY
PUDUCHERRY,2008,Self-employed (Business activity),0,1,3,3,0,7,0,0,0,0,0,0,7,PY
PUDUCHERRY,2008,Professional Activity,0,0,0,0,0,0,0,0,0,0,0,0,0,PY
PUDUCHERRY,2008,Farming/Agriculture Activity,0,2,9,3,0,14,0,2,1,0,0,3,17,PY
PUDUCHERRY,2008,Retired Person,0,1,0,0,0,1,0,0,0,0,0,0,1,PY
PUDUCHERRY,2008,Total,2,90,122,94,26,334,0,105,46,9,13,173,507,PY
PUDUCHERRY,2008,Total Salaried,0,5,5,7,1,18,0,7,3,0,1,11,29,PY
PUDUCHERRY,2008,Total Self-employed,0,50,96,78,12,236,0,11,3,1,0,15,251,PY
PUNJAB,2008,Others (Please Specify),5,69,95,68,26,263,6,18,14,3,1,42,305,PN
PUNJAB,2008,House Wife,0,0,0,0,0,0,1,66,66,15,8,156,156,PN
PUNJAB,2008,Service (Government),0,4,16,9,0,29,0,0,0,0,0,0,29,PN
PUNJAB,2008,Service (Private),0,35,36,12,0,83,0,2,3,0,0,5,88,PN
PUNJAB,2008,Public Sector Undertaking,0,1,1,0,0,2,0,0,0,0,0,0,2,PN
PUNJAB,2008,Student,2,23,0,1,0,26,3,19,0,0,0,22,48,PN
PUNJAB,2008,Unemployed,0,24,20,7,3,54,0,1,0,0,0,1,55,PN
PUNJAB,2008,Self-employed (Business activity),0,26,45,21,13,105,0,0,0,0,0,0,105,PN
PUNJAB,2008,Professional Activity,0,4,4,3,2,13,0,0,0,0,0,0,13,PN
PUNJAB,2008,Farming/Agriculture Activity,1,18,32,9,6,66,0,0,0,0,0,0,66,PN
PUNJAB,2008,Retired Person,0,0,0,0,2,2,0,0,0,0,0,0,2,PN
PUNJAB,2008,Total,8,204,249,130,52,643,10,106,83,18,9,226,869,PN
PUNJAB,2008,Total Salaried,0,40,53,21,0,114,0,2,3,0,0,5,119,PN
PUNJAB,2008,Total Self-employed,4,85,122,69,28,308,1,14,12,3,1,31,339,PN
RAJASTHAN,2008,Others (Please Specify),89,589,639,330,100,1747,35,154,73,58,12,332,2079,RJ
RAJASTHAN,2008,House Wife,0,0,0,0,0,0,18,360,389,147,44,958,958,RJ
RAJASTHAN,2008,Service (Government),0,13,31,18,1,63,0,13,7,6,0,26,89,RJ
RAJASTHAN,2008,Service (Private),0,136,206,86,3,431,0,27,5,3,0,35,466,RJ
RAJASTHAN,2008,Public Sector Undertaking,0,6,6,4,1,17,0,1,1,0,0,2,19,RJ
RAJASTHAN,2008,Student,29,101,43,0,0,173,13,53,3,0,0,69,242,RJ
RAJASTHAN,2008,Unemployed,0,81,65,22,8,176,0,15,12,4,0,31,207,RJ
RAJASTHAN,2008,Self-employed (Business activity),0,57,109,66,2,234,0,2,3,5,0,10,244,RJ
RAJASTHAN,2008,Professional Activity,0,18,24,8,3,53,0,0,0,0,0,0,53,RJ
RAJASTHAN,2008,Farming/Agriculture Activity,0,156,287,212,40,695,2,33,56,7,3,101,796,RJ
RAJASTHAN,2008,Retired Person,0,5,5,2,1,13,0,0,0,0,0,0,13,RJ
RAJASTHAN,2008,Total,118,1162,1415,748,159,3602,68,658,549,230,59,1564,5166,RJ
RAJASTHAN,2008,Total Salaried,0,155,243,108,5,511,0,41,13,9,0,63,574,RJ
RAJASTHAN,2008,Total Self-employed,38,567,812,447,90,1954,11,115,92,50,7,275,2229,RJ
SIKKIM,2008,Others (Please Specify),0,30,33,36,4,103,0,6,9,4,3,22,125,SK
SIKKIM,2008,House Wife,0,0,0,0,0,0,0,6,0,1,0,7,7,SK
SIKKIM,2008,Service (Government),0,0,0,0,0,0,0,0,0,0,0,0,0,SK
SIKKIM,2008,Service (Private),0,8,4,6,2,20,0,2,4,2,0,8,28,SK
SIKKIM,2008,Public Sector Undertaking,0,0,0,0,0,0,0,3,1,2,0,6,6,SK
SIKKIM,2008,Student,2,6,0,0,0,8,0,4,0,0,0,4,12,SK
SIKKIM,2008,Unemployed,0,16,11,6,3,36,0,3,6,4,0,13,49,SK
SIKKIM,2008,Self-employed (Business activity),0,0,0,0,0,0,0,0,0,0,0,0,0,SK
SIKKIM,2008,Professional Activity,0,0,0,0,0,0,0,0,0,0,0,0,0,SK
SIKKIM,2008,Farming/Agriculture Activity,0,10,21,17,1,49,0,2,6,0,3,11,60,SK
SIKKIM,2008,Retired Person,0,0,0,0,0,0,0,0,0,0,0,0,0,SK
SIKKIM,2008,Total,2,70,69,65,10,216,0,26,26,13,6,71,287,SK
SIKKIM,2008,Total Salaried,0,8,4,6,2,20,0,5,5,4,0,14,34,SK
SIKKIM,2008,Total Self-employed,0,30,41,33,5,109,0,2,6,0,3,11,120,SK
TAMIL NADU,2008,Others (Please Specify),0,1184,1132,1175,479,3970,40,363,310,207,143,1063,5033,TN
TAMIL NADU,2008,House Wife,0,0,0,0,0,0,0,841,986,470,133,2430,2430,TN
TAMIL NADU,2008,Service (Government),0,31,153,83,2,269,0,20,11,9,6,46,315,TN
TAMIL NADU,2008,Service (Private),0,357,520,385,71,1333,0,476,120,84,8,688,2021,TN
TAMIL NADU,2008,Public Sector Undertaking,0,75,132,71,3,281,0,31,15,54,7,107,388,TN
TAMIL NADU,2008,Student,30,84,0,0,0,114,43,97,4,0,0,144,258,TN
TAMIL NADU,2008,Unemployed,0,431,134,197,111,873,0,263,145,75,10,493,1366,TN
TAMIL NADU,2008,Self-employed (Business activity),0,196,854,201,35,1286,0,29,95,13,4,141,1427,TN
TAMIL NADU,2008,Professional Activity,0,110,170,95,41,416,0,55,49,28,10,142,558,TN
TAMIL NADU,2008,Farming/Agriculture Activity,0,95,170,95,40,400,0,40,46,24,2,112,512,TN
TAMIL NADU,2008,Retired Person,0,0,0,12,89,101,0,0,0,0,16,16,117,TN
TAMIL NADU,2008,Total,30,2563,3265,2314,871,9043,83,2215,1781,964,339,5382,14425,TN
TAMIL NADU,2008,Total Salaried,0,463,805,539,76,1883,0,527,146,147,21,841,2724,TN
TAMIL NADU,2008,Total Self-employed,0,1287,1904,1241,441,4873,0,382,365,188,100,1035,5908,TN
TRIPURA,2008,Others (Please Specify),0,53,61,37,12,163,1,48,36,18,4,107,270,TR
TRIPURA,2008,House Wife,0,0,0,0,0,0,0,56,43,29,2,130,130,TR
TRIPURA,2008,Service (Government),0,3,9,3,0,15,0,0,0,0,0,0,15,TR
TRIPURA,2008,Service (Private),0,4,8,2,0,14,0,0,7,4,0,11,25,TR
TRIPURA,2008,Public Sector Undertaking,0,0,0,2,0,2,0,0,0,0,0,0,2,TR
TRIPURA,2008,Student,9,43,0,0,0,52,13,26,0,0,0,39,91,TR
TRIPURA,2008,Unemployed,0,32,61,27,13,133,0,13,5,0,0,18,151,TR
TRIPURA,2008,Self-employed (Business activity),0,7,8,3,0,18,0,0,0,0,0,0,18,TR
TRIPURA,2008,Professional Activity,0,0,0,0,0,0,0,0,0,0,0,0,0,TR
TRIPURA,2008,Farming/Agriculture Activity,0,10,20,15,0,45,0,0,5,0,0,5,50,TR
TRIPURA,2008,Retired Person,0,0,0,0,0,0,0,0,0,0,0,0,0,TR
TRIPURA,2008,Total,9,152,167,89,25,442,14,143,96,51,6,310,752,TR
TRIPURA,2008,Total Salaried,0,7,17,7,0,31,0,0,7,4,0,11,42,TR
TRIPURA,2008,Total Self-employed,0,42,66,35,12,155,0,19,15,5,0,39,194,TR
UTTAR PRADESH,2008,Others (Please Specify),30,228,181,153,58,650,30,223,70,31,23,377,1027,UP
UTTAR PRADESH,2008,House Wife,0,0,0,0,0,0,10,618,337,91,49,1105,1105,UP
UTTAR PRADESH,2008,Service (Government),0,8,15,7,0,30,0,9,5,0,0,14,44,UP
UTTAR PRADESH,2008,Service (Private),0,102,84,4,2,192,0,24,12,5,0,41,233,UP
UTTAR PRADESH,2008,Public Sector Undertaking,0,18,19,5,1,43,0,3,4,4,0,11,54,UP
UTTAR PRADESH,2008,Student,27,148,22,1,2,200,25,125,4,0,0,154,354,UP
UTTAR PRADESH,2008,Unemployed,1,101,90,32,15,239,0,25,17,4,1,47,286,UP
UTTAR PRADESH,2008,Self-employed (Business activity),1,29,70,53,28,181,4,5,10,1,2,22,203,UP
UTTAR PRADESH,2008,Professional Activity,0,6,9,6,1,22,0,7,1,1,0,9,31,UP
UTTAR PRADESH,2008,Farming/Agriculture Activity,1,128,267,156,64,616,0,44,59,14,12,129,745,UP
UTTAR PRADESH,2008,Retired Person,0,0,1,2,3,6,0,0,0,0,0,0,6,UP
UTTAR PRADESH,2008,Total,60,768,758,419,174,2179,69,1083,519,151,87,1909,4088,UP
UTTAR PRADESH,2008,Total Salaried,0,128,118,16,3,265,0,36,21,9,0,66,331,UP
UTTAR PRADESH,2008,Total Self-employed,21,315,452,316,137,1241,29,220,110,33,30,422,1663,UP
UTTARAKHAND,2008,Others (Please Specify),7,6,10,7,4,34,1,16,2,1,0,20,54,UK
UTTARAKHAND,2008,House Wife,0,0,0,0,0,0,0,32,8,4,0,44,44,UK
UTTARAKHAND,2008,Service (Government),0,4,2,1,0,7,0,0,0,0,0,0,7,UK
UTTARAKHAND,2008,Service (Private),1,7,7,2,0,17,0,3,2,1,0,6,23,UK
UTTARAKHAND,2008,Public Sector Undertaking,0,2,2,1,0,5,0,0,0,1,0,1,6,UK
UTTARAKHAND,2008,Student,0,4,2,0,0,6,2,5,0,0,0,7,13,UK
UTTARAKHAND,2008,Unemployed,0,5,0,0,0,5,0,1,1,0,0,2,7,UK
UTTARAKHAND,2008,Self-employed (Business activity),0,3,2,1,0,6,0,0,0,0,0,0,6,UK
UTTARAKHAND,2008,Professional Activity,0,0,0,0,0,0,0,0,0,0,0,0,0,UK
UTTARAKHAND,2008,Farming/Agriculture Activity,0,6,10,5,0,21,0,4,2,1,0,7,28,UK
UTTARAKHAND,2008,Retired Person,0,0,0,3,0,3,0,0,0,0,0,0,3,UK
UTTARAKHAND,2008,Total,8,37,35,20,4,104,3,61,15,8,0,87,191,UK
UTTARAKHAND,2008,Total Salaried,1,13,11,4,0,29,0,3,2,2,0,7,36,UK
UTTARAKHAND,2008,Total Self-employed,2,11,17,8,2,40,1,16,4,1,0,22,62,UK
WEST BENGAL,2008,Others (Please Specify),152,1282,1454,552,232,3672,107,873,599,360,102,2041,5713,WB
WEST BENGAL,2008,House Wife,0,0,0,0,0,0,0,1607,1172,406,59,3244,3244,WB
WEST BENGAL,2008,Service (Government),0,17,62,41,0,120,0,4,7,14,0,25,145,WB
WEST BENGAL,2008,Service (Private),2,122,214,190,7,535,0,29,38,16,0,83,618,WB
WEST BENGAL,2008,Public Sector Undertaking,0,58,275,201,3,537,1,19,43,22,0,85,622,WB
WEST BENGAL,2008,Student,112,430,13,0,0,555,118,262,5,0,0,385,940,WB
WEST BENGAL,2008,Unemployed,9,460,471,166,5,1111,15,152,212,66,1,446,1557,WB
WEST BENGAL,2008,Self-employed (Business activity),0,242,403,210,27,882,0,16,30,6,0,52,934,WB
WEST BENGAL,2008,Professional Activity,0,34,124,74,2,234,0,9,4,0,0,13,247,WB
WEST BENGAL,2008,Farming/Agriculture Activity,0,161,311,159,29,660,0,33,50,12,4,99,759,WB
WEST BENGAL,2008,Retired Person,0,0,0,0,63,63,0,0,0,0,10,10,73,WB
WEST BENGAL,2008,Total,275,2806,3327,1593,368,8369,241,3004,2160,902,176,6483,14852,WB
WEST BENGAL,2008,Total Salaried,2,197,551,432,10,1192,1,52,88,52,0,193,1385,WB
WEST BENGAL,2008,Total Self-employed,63,1102,1363,631,156,3315,25,382,251,124,34,816,4131,WB
A & N ISLANDS,2009,Others (Please Specify),0,4,1,1,0,6,0,2,1,0,0,3,9,AN
A & N ISLANDS,2009,House Wife,0,0,0,0,0,0,0,14,10,4,1,29,29,AN
A & N ISLANDS,2009,Service (Government),0,0,3,9,1,13,0,0,1,0,0,1,14,AN
A & N ISLANDS,2009,Service (Private),0,20,10,10,2,42,0,0,2,0,0,2,44,AN
A & N ISLANDS,2009,Public Sector Undertaking,0,0,0,0,0,0,0,0,0,0,0,0,0,AN
A & N ISLANDS,2009,Student,1,2,0,0,0,3,7,3,0,0,0,10,13,AN
A & N ISLANDS,2009,Unemployed,0,0,0,0,0,0,0,0,0,0,0,0,0,AN
A & N ISLANDS,2009,Self-employed (Business activity),0,0,2,0,0,2,0,0,0,0,0,0,2,AN
A & N ISLANDS,2009,Professional Activity,0,0,0,0,0,0,0,0,0,0,0,0,0,AN
A & N ISLANDS,2009,Farming/Agriculture Activity,0,5,7,5,2,19,0,0,0,0,0,0,19,AN
A & N ISLANDS,2009,Retired Person,0,0,0,0,1,1,0,0,0,0,0,0,1,AN
A & N ISLANDS,2009,Total,1,31,23,25,6,86,7,19,14,4,1,45,131,AN
A & N ISLANDS,2009,Total Salaried,0,20,13,19,3,55,0,0,3,0,0,3,58,AN
A & N ISLANDS,2009,Total Self-employed,0,9,10,6,2,27,0,2,1,0,0,3,30,AN
ANDHRA PRADESH,2009,Others (Please Specify),24,879,1189,820,244,3156,57,418,376,239,94,1184,4340,AP
ANDHRA PRADESH,2009,House Wife,0,0,0,0,0,0,0,1033,779,428,151,2391,2391,AP
ANDHRA PRADESH,2009,Service (Government),0,54,100,57,2,213,0,13,6,2,0,21,234,AP
ANDHRA PRADESH,2009,Service (Private),0,277,468,222,79,1046,0,65,44,33,19,161,1207,AP
ANDHRA PRADESH,2009,Public Sector Undertaking,0,154,203,152,78,587,0,36,20,8,14,78,665,AP
ANDHRA PRADESH,2009,Student,38,293,33,0,0,364,65,164,4,0,0,233,597,AP
ANDHRA PRADESH,2009,Unemployed,0,263,252,129,0,644,0,41,15,14,0,70,714,AP
ANDHRA PRADESH,2009,Self-employed (Business activity),0,341,460,387,138,1326,0,14,9,1,1,25,1351,AP
ANDHRA PRADESH,2009,Professional Activity,0,74,132,249,11,466,0,18,1,3,1,23,489,AP
ANDHRA PRADESH,2009,Farming/Agriculture Activity,5,392,885,562,172,2016,5,132,141,100,20,398,2414,AP
ANDHRA PRADESH,2009,Retired Person,0,0,0,8,61,69,0,0,25,1,3,29,98,AP
ANDHRA PRADESH,2009,Total,67,2727,3722,2586,785,9887,127,1934,1420,829,303,4613,14500,AP
ANDHRA PRADESH,2009,Total Salaried,0,485,771,431,159,1846,0,114,70,43,33,260,2106,AP
ANDHRA PRADESH,2009,Total Self-employed,13,1348,2205,1730,458,5754,30,393,391,229,73,1116,6870,AP
ARUNACHAL PRADESH,2009,Others (Please Specify),1,19,2,0,0,22,0,10,1,0,0,11,33,AR
ARUNACHAL PRADESH,2009,House Wife,0,0,0,0,0,0,0,6,7,1,0,14,14,AR
ARUNACHAL PRADESH,2009,Service (Government),0,10,14,1,0,25,0,0,1,0,0,1,26,AR
ARUNACHAL PRADESH,2009,Service (Private),0,3,2,0,0,5,0,0,3,0,0,3,8,AR
ARUNACHAL PRADESH,2009,Public Sector Undertaking,0,0,0,0,0,0,0,0,0,0,0,0,0,AR
ARUNACHAL PRADESH,2009,Student,1,1,0,0,0,2,0,3,0,0,0,3,5,AR
ARUNACHAL PRADESH,2009,Unemployed,0,4,6,1,0,11,0,0,1,0,0,1,12,AR
ARUNACHAL PRADESH,2009,Self-employed (Business activity),0,0,0,0,0,0,0,0,0,0,0,0,0,AR
ARUNACHAL PRADESH,2009,Professional Activity,0,0,0,0,0,0,0,0,0,0,0,0,0,AR
ARUNACHAL PRADESH,2009,Farming/Agriculture Activity,0,6,1,5,0,12,0,0,0,0,0,0,12,AR
ARUNACHAL PRADESH,2009,Retired Person,0,0,0,0,0,0,0,0,0,0,0,0,0,AR
ARUNACHAL PRADESH,2009,Total,2,43,25,7,0,77,0,19,13,1,0,33,110,AR
ARUNACHAL PRADESH,2009,Total Salaried,0,13,16,1,0,30,0,0,4,0,0,4,34,AR
ARUNACHAL PRADESH,2009,Total Self-employed,0,25,2,5,0,32,0,10,1,0,0,11,43,AR
ASSAM,2009,Others (Please Specify),16,260,281,162,43,762,16,151,88,52,14,321,1083,AS
ASSAM,2009,House Wife,0,0,0,0,0,0,0,222,213,94,12,541,541,AS
ASSAM,2009,Service (Government),0,1,1,3,0,5,0,0,0,0,0,0,5,AS
ASSAM,2009,Service (Private),0,27,13,15,1,56,0,4,2,1,0,7,63,AS
ASSAM,2009,Public Sector Undertaking,0,13,23,14,0,50,0,3,3,8,0,14,64,AS
ASSAM,2009,Student,11,118,0,0,0,129,8,83,0,0,0,91,220,AS
ASSAM,2009,Unemployed,0,3,24,31,0,58,0,3,6,6,0,15,73,AS
ASSAM,2009,Self-employed (Business activity),0,101,164,94,2,361,0,36,16,7,0,59,420,AS
ASSAM,2009,Professional Activity,0,37,69,23,2,131,0,4,5,3,0,12,143,AS
ASSAM,2009,Farming/Agriculture Activity,0,95,137,80,5,317,0,8,7,9,0,24,341,AS
ASSAM,2009,Retired Person,0,0,0,3,10,13,0,0,0,0,0,0,13,AS
ASSAM,2009,Total,27,655,712,425,63,1882,24,514,340,180,26,1084,2966,AS
ASSAM,2009,Total Salaried,0,41,37,32,1,111,0,7,5,9,0,21,132,AS
ASSAM,2009,Total Self-employed,9,443,590,311,40,1393,7,155,95,65,11,333,1726,AS
BIHAR,2009,Others (Please Specify),15,96,78,42,20,251,19,72,31,12,4,138,389,BR
BIHAR,2009,House Wife,0,0,0,0,0,0,0,124,154,29,7,314,314,BR
BIHAR,2009,Service (Government),0,2,1,0,0,3,0,0,0,0,0,0,3,BR
BIHAR,2009,Service (Private),0,17,35,3,0,55,0,2,0,0,0,2,57,BR
BIHAR,2009,Public Sector Undertaking,0,1,7,0,0,8,0,0,0,0,0,0,8,BR
BIHAR,2009,Student,7,31,4,0,0,42,5,19,2,0,0,26,68,BR
BIHAR,2009,Unemployed,0,24,19,0,0,43,1,1,6,0,0,8,51,BR
BIHAR,2009,Self-employed (Business activity),0,9,9,6,0,24,0,0,0,0,0,0,24,BR
BIHAR,2009,Professional Activity,0,2,0,1,0,3,0,0,22,0,0,22,25,BR
BIHAR,2009,Farming/Agriculture Activity,0,20,40,23,2,85,0,10,17,0,0,27,112,BR
BIHAR,2009,Retired Person,0,0,0,0,0,0,0,0,0,0,0,0,0,BR
BIHAR,2009,Total,22,202,193,75,22,514,25,228,232,41,11,537,1051,BR
BIHAR,2009,Total Salaried,0,20,43,3,0,66,0,2,0,0,0,2,68,BR
BIHAR,2009,Total Self-employed,3,65,82,41,3,194,0,10,43,2,0,55,249,BR
CHANDIGARH,2009,Others (Please Specify),0,2,0,0,0,2,0,1,0,0,0,1,3,CH
CHANDIGARH,2009,House Wife,0,0,0,0,0,0,0,6,8,1,2,17,17,CH
CHANDIGARH,2009,Service (Government),0,0,4,3,0,7,0,0,0,0,0,0,7,CH
CHANDIGARH,2009,Service (Private),0,0,3,2,0,5,0,0,1,0,0,1,6,CH
CHANDIGARH,2009,Public Sector Undertaking,0,5,6,1,0,12,0,0,0,0,0,0,12,CH
CHANDIGARH,2009,Student,0,6,0,0,0,6,1,11,0,0,0,12,18,CH
CHANDIGARH,2009,Unemployed,0,3,3,1,0,7,0,0,0,0,0,0,7,CH
CHANDIGARH,2009,Self-employed (Business activity),0,0,1,1,1,3,0,0,0,0,0,0,3,CH
CHANDIGARH,2009,Professional Activity,0,0,1,0,0,1,0,0,0,0,0,0,1,CH
CHANDIGARH,2009,Farming/Agriculture Activity,0,0,0,0,0,0,0,0,0,0,0,0,0,CH
CHANDIGARH,2009,Retired Person,0,0,0,0,1,1,0,0,0,0,0,0,1,CH
CHANDIGARH,2009,Total,0,16,18,8,2,44,1,18,9,1,2,31,75,CH
CHANDIGARH,2009,Total Salaried,0,5,13,6,0,24,0,0,1,0,0,1,25,CH
CHANDIGARH,2009,Total Self-employed,0,1,2,1,1,5,0,0,0,0,0,0,5,CH
CHHATTISGARH,2009,Others (Please Specify),32,294,422,298,183,1229,32,119,134,89,39,413,1642,CG
CHHATTISGARH,2009,House Wife,0,0,0,0,0,0,4,466,299,99,34,902,902,CG
CHHATTISGARH,2009,Service (Government),0,19,14,9,0,42,0,5,1,0,0,6,48,CG
CHHATTISGARH,2009,Service (Private),0,89,101,54,5,249,0,31,11,3,0,45,294,CG
CHHATTISGARH,2009,Public Sector Undertaking,0,5,7,5,0,17,0,0,0,0,0,0,17,CG
CHHATTISGARH,2009,Student,59,228,11,0,0,298,33,99,5,0,0,137,435,CG
CHHATTISGARH,2009,Unemployed,4,159,204,87,7,461,4,5,18,1,0,28,489,CG
CHHATTISGARH,2009,Self-employed (Business activity),0,34,31,33,6,104,0,1,2,1,0,4,108,CG
CHHATTISGARH,2009,Professional Activity,0,33,56,39,3,131,0,3,2,1,0,6,137,CG
CHHATTISGARH,2009,Farming/Agriculture Activity,9,364,496,412,136,1417,3,144,115,97,26,385,1802,CG
CHHATTISGARH,2009,Retired Person,0,0,0,0,6,6,0,0,0,0,3,3,9,CG
CHHATTISGARH,2009,Total,104,1225,1342,937,346,3954,76,873,587,291,102,1929,5883,CG
CHHATTISGARH,2009,Total Salaried,0,113,122,68,5,308,0,36,12,3,0,51,359,CG
CHHATTISGARH,2009,Total Self-employed,13,584,801,693,244,2335,6,207,195,131,34,573,2908,CG
D & N HAVELI,2009,Others (Please Specify),0,0,1,0,0,1,0,0,0,0,1,1,2,DN
D & N HAVELI,2009,House Wife,0,0,0,0,0,0,0,10,2,1,6,19,19,DN
D & N HAVELI,2009,Service (Government),0,0,1,0,0,1,0,0,0,0,0,0,1,DN
D & N HAVELI,2009,Service (Private),0,6,3,1,0,10,0,0,2,0,0,2,12,DN
D & N HAVELI,2009,Public Sector Undertaking,0,0,0,0,0,0,0,0,0,0,0,0,0,DN
D & N HAVELI,2009,Student,0,2,0,0,0,2,0,4,0,0,0,4,6,DN
D & N HAVELI,2009,Unemployed,0,0,0,0,0,0,0,0,0,0,0,0,0,DN
D & N HAVELI,2009,Self-employed (Business activity),0,0,0,1,0,1,0,0,0,0,0,0,1,DN
D & N HAVELI,2009,Professional Activity,0,0,0,0,0,0,0,0,0,0,0,0,0,DN
D & N HAVELI,2009,Farming/Agriculture Activity,0,2,5,6,2,15,0,0,0,0,0,0,15,DN
D & N HAVELI,2009,Retired Person,0,0,0,0,0,0,0,0,0,0,0,0,0,DN
D & N HAVELI,2009,Total,0,10,10,8,2,30,0,14,4,1,7,26,56,DN
D & N HAVELI,2009,Total Salaried,0,6,4,1,0,11,0,0,2,0,0,2,13,DN
D & N HAVELI,2009,Total Self-employed,0,2,6,7,2,17,0,0,0,0,1,1,18,DN
DAMAN & DIU,2009,Others (Please Specify),0,1,2,1,2,6,0,0,1,0,0,1,7,DD
DAMAN & DIU,2009,House Wife,0,0,0,0,0,0,0,0,3,1,0,4,4,DD
DAMAN & DIU,2009,Service (Government),0,0,0,0,0,0,0,0,0,0,0,0,0,DD
DAMAN & DIU,2009,Service (Private),0,6,0,0,0,6,0,0,1,0,0,1,7,DD
DAMAN & DIU,2009,Public Sector Undertaking,0,0,0,0,0,0,0,1,0,0,0,1,1,DD
DAMAN & DIU,2009,Student,0,1,0,1,0,2,1,0,0,0,0,1,3,DD
DAMAN & DIU,2009,Unemployed,0,0,0,1,0,1,0,0,0,0,0,0,1,DD
DAMAN & DIU,2009,Self-employed (Business activity),0,0,0,0,0,0,0,0,0,0,0,0,0,DD
DAMAN & DIU,2009,Professional Activity,0,0,0,0,0,0,0,0,0,0,0,0,0,DD
DAMAN & DIU,2009,Farming/Agriculture Activity,0,0,0,0,0,0,0,0,0,0,0,0,0,DD
DAMAN & DIU,2009,Retired Person,0,0,0,0,0,0,0,0,0,0,0,0,0,DD
DAMAN & DIU,2009,Total,0,8,2,3,2,15,1,1,5,1,0,8,23,DD
DAMAN & DIU,2009,Total Salaried,0,6,0,0,0,6,0,1,1,0,0,2,8,DD
DAMAN & DIU,2009,Total Self-employed,0,0,0,0,0,0,0,0,0,0,0,0,0,DD
DELHI (UT),2009,Others (Please Specify),4,123,104,43,15,289,7,54,15,10,1,87,376,DL
DELHI (UT),2009,House Wife,0,0,0,0,0,0,0,198,98,21,6,323,323,DL
DELHI (UT),2009,Service (Government),0,4,9,5,0,18,0,1,1,0,0,2,20,DL
DELHI (UT),2009,Service (Private),0,88,99,21,2,210,0,16,3,2,0,21,231,DL
DELHI (UT),2009,Public Sector Undertaking,0,9,11,4,0,24,0,2,0,0,0,2,26,DL
DELHI (UT),2009,Student,10,87,2,0,0,99,7,58,1,0,0,66,165,DL
DELHI (UT),2009,Unemployed,1,129,80,25,3,238,5,30,7,0,0,42,280,DL
DELHI (UT),2009,Self-employed (Business activity),0,13,12,5,1,31,0,0,0,0,0,0,31,DL
DELHI (UT),2009,Professional Activity,0,3,5,4,0,12,0,1,0,0,0,1,13,DL
DELHI (UT),2009,Farming/Agriculture Activity,0,1,3,1,0,5,0,0,0,0,0,0,5,DL
DELHI (UT),2009,Retired Person,0,0,0,0,7,7,0,0,0,0,0,0,7,DL
DELHI (UT),2009,Total,15,457,325,108,28,933,19,360,125,33,7,544,1477,DL
DELHI (UT),2009,Total Salaried,0,101,119,30,2,252,0,19,4,2,0,25,277,DL
DELHI (UT),2009,Total Self-employed,0,56,63,32,5,156,0,13,8,4,0,25,181,DL
GOA,2009,Others (Please Specify),0,8,24,13,10,55,0,6,0,1,0,7,62,GA
GOA,2009,House Wife,0,0,0,0,0,0,0,24,19,10,7,60,60,GA
GOA,2009,Service (Government),0,2,2,1,0,5,0,2,2,1,0,5,10,GA
GOA,2009,Service (Private),0,14,19,10,1,44,0,6,0,0,0,6,50,GA
GOA,2009,Public Sector Undertaking,0,1,0,2,0,3,0,0,0,0,0,0,3,GA
GOA,2009,Student,1,7,0,0,0,8,2,4,0,1,0,7,15,GA
GOA,2009,Unemployed,0,15,22,16,0,53,0,4,0,1,1,6,59,GA
GOA,2009,Self-employed (Business activity),0,2,1,0,1,4,0,2,0,0,0,2,6,GA
GOA,2009,Professional Activity,0,1,2,1,0,4,0,0,1,0,0,1,5,GA
GOA,2009,Farming/Agriculture Activity,0,0,2,1,1,4,0,0,0,0,0,0,4,GA
GOA,2009,Retired Person,0,0,0,0,4,4,0,0,0,0,0,0,4,GA
GOA,2009,Total,1,50,72,44,17,184,2,48,22,14,8,94,278,GA
GOA,2009,Total Salaried,0,17,21,13,1,52,0,8,2,1,0,11,63,GA
GOA,2009,Total Self-employed,0,8,8,8,7,31,0,5,1,1,0,7,38,GA
GUJARAT,2009,Others (Please Specify),9,249,317,207,64,846,2,114,72,37,33,258,1104,GJ
GUJARAT,2009,House Wife,0,0,0,0,0,0,3,781,580,262,110,1736,1736,GJ
GUJARAT,2009,Service (Government),0,10,19,13,1,43,0,17,4,4,1,26,69,GJ
GUJARAT,2009,Service (Private),0,192,247,133,9,581,0,16,24,8,0,48,629,GJ
GUJARAT,2009,Public Sector Undertaking,0,24,48,17,2,91,0,13,6,5,0,24,115,GJ
GUJARAT,2009,Student,17,154,2,1,0,174,25,118,10,1,0,154,328,GJ
GUJARAT,2009,Unemployed,1,184,226,69,19,499,0,43,28,7,2,80,579,GJ
GUJARAT,2009,Self-employed (Business activity),0,108,148,65,15,336,0,0,0,2,0,2,338,GJ
GUJARAT,2009,Professional Activity,0,180,198,109,22,509,0,21,16,6,0,43,552,GJ
GUJARAT,2009,Farming/Agriculture Activity,0,153,198,107,40,498,0,36,30,14,10,90,588,GJ
GUJARAT,2009,Retired Person,0,1,1,16,76,94,0,0,1,2,21,24,118,GJ
GUJARAT,2009,Total,27,1255,1404,737,248,3671,30,1159,771,348,177,2485,6156,GJ
GUJARAT,2009,Total Salaried,0,226,314,163,12,715,0,46,34,17,1,98,813,GJ
GUJARAT,2009,Total Self-employed,4,609,760,400,117,1890,1,121,95,47,35,299,2189,GJ
HARYANA,2009,Others (Please Specify),28,308,277,148,52,813,16,58,16,33,9,132,945,HR
HARYANA,2009,House Wife,0,0,0,0,0,0,2,176,196,57,10,441,441,HR
HARYANA,2009,Service (Government),0,26,34,15,5,80,0,3,3,0,0,6,86,HR
HARYANA,2009,Service (Private),0,100,98,47,8,253,0,16,13,3,0,32,285,HR
HARYANA,2009,Public Sector Undertaking,0,35,19,8,2,64,0,7,0,0,0,7,71,HR
HARYANA,2009,Student,10,70,3,0,0,83,16,16,0,0,0,32,115,HR
HARYANA,2009,Unemployed,0,86,90,37,7,220,0,17,15,0,1,33,253,HR
HARYANA,2009,Self-employed (Business activity),0,16,18,13,2,49,0,0,0,0,0,0,49,HR
HARYANA,2009,Professional Activity,0,7,13,8,0,28,0,0,0,0,0,0,28,HR
HARYANA,2009,Farming/Agriculture Activity,0,44,107,62,12,225,0,1,2,2,0,5,230,HR
HARYANA,2009,Retired Person,0,0,0,0,0,0,0,0,0,0,0,0,0,HR
HARYANA,2009,Total,38,692,659,338,88,1815,34,294,245,95,20,688,2503,HR
HARYANA,2009,Total Salaried,0,161,151,70,15,397,0,26,16,3,0,45,442,HR
HARYANA,2009,Total Self-employed,0,143,195,104,24,466,3,2,2,2,0,9,475,HR
HIMACHAL PRADESH,2009,Others (Please Specify),3,58,56,30,16,163,7,18,9,4,4,42,205,HP
HIMACHAL PRADESH,2009,House Wife,0,0,0,0,0,0,0,38,32,14,10,94,94,HP
HIMACHAL PRADESH,2009,Service (Government),0,5,13,8,0,26,0,0,5,1,0,6,32,HP
HIMACHAL PRADESH,2009,Service (Private),0,11,19,5,0,35,0,2,2,3,0,7,42,HP
HIMACHAL PRADESH,2009,Public Sector Undertaking,0,7,3,5,3,18,0,2,0,3,1,6,24,HP
HIMACHAL PRADESH,2009,Student,2,21,2,0,0,25,4,21,0,0,0,25,50,HP
HIMACHAL PRADESH,2009,Unemployed,0,22,15,11,4,52,0,3,6,1,2,12,64,HP
HIMACHAL PRADESH,2009,Self-employed (Business activity),0,1,9,3,3,16,0,0,1,0,0,1,17,HP
HIMACHAL PRADESH,2009,Professional Activity,0,0,3,0,0,3,0,0,0,0,0,0,3,HP
HIMACHAL PRADESH,2009,Farming/Agriculture Activity,0,1,8,10,5,24,0,0,0,0,0,0,24,HP
HIMACHAL PRADESH,2009,Retired Person,0,0,0,0,4,4,0,0,0,0,1,1,5,HP
HIMACHAL PRADESH,2009,Total,5,126,128,72,35,366,11,84,55,26,18,194,560,HP
HIMACHAL PRADESH,2009,Total Salaried,0,23,35,18,3,79,0,4,7,7,1,19,98,HP
HIMACHAL PRADESH,2009,Total Self-employed,1,9,32,24,13,79,0,3,3,1,1,8,87,HP
JAMMU & KASHMIR,2009,Others (Please Specify),0,9,18,7,6,40,2,19,18,4,5,48,88,JK
JAMMU & KASHMIR,2009,House Wife,0,0,0,0,0,0,0,34,14,1,1,50,50,JK
JAMMU & KASHMIR,2009,Service (Government),0,8,14,4,0,26,0,3,4,2,0,9,35,JK
JAMMU & KASHMIR,2009,Service (Private),0,4,11,6,3,24,0,2,3,1,0,6,30,JK
JAMMU & KASHMIR,2009,Public Sector Undertaking,0,1,2,1,2,6,0,0,1,0,0,1,7,JK
JAMMU & KASHMIR,2009,Student,0,3,1,0,0,4,0,12,4,0,0,16,20,JK
JAMMU & KASHMIR,2009,Unemployed,0,12,20,9,0,41,0,9,10,2,0,21,62,JK
JAMMU & KASHMIR,2009,Self-employed (Business activity),0,1,5,7,4,17,0,1,0,0,0,1,18,JK
JAMMU & KASHMIR,2009,Professional Activity,0,0,2,0,0,2,0,1,0,0,0,1,3,JK
JAMMU & KASHMIR,2009,Farming/Agriculture Activity,0,6,1,0,1,8,0,0,0,0,0,0,8,JK
JAMMU & KASHMIR,2009,Retired Person,0,0,0,0,0,0,0,0,0,0,0,0,0,JK
JAMMU & KASHMIR,2009,Total,0,44,74,34,16,168,2,81,54,10,6,153,321,JK
JAMMU & KASHMIR,2009,Total Salaried,0,13,27,11,5,56,0,5,8,3,0,16,72,JK
JAMMU & KASHMIR,2009,Total Self-employed,0,10,18,12,8,48,2,7,6,3,3,21,69,JK
JHARKHAND,2009,Others (Please Specify),9,56,39,104,33,241,12,29,20,22,19,102,343,JH
JHARKHAND,2009,House Wife,0,0,0,0,0,0,0,54,87,40,4,185,185,JH
JHARKHAND,2009,Service (Government),0,1,14,2,0,17,0,5,2,0,0,7,24,JH
JHARKHAND,2009,Service (Private),0,21,68,30,1,120,1,12,2,1,0,16,136,JH
JHARKHAND,2009,Public Sector Undertaking,0,1,1,1,0,3,1,0,0,0,0,1,4,JH
JHARKHAND,2009,Student,7,53,3,0,0,63,8,25,0,0,0,33,96,JH
JHARKHAND,2009,Unemployed,0,23,39,15,10,87,0,7,6,0,0,13,100,JH
JHARKHAND,2009,Self-employed (Business activity),0,7,15,11,0,33,0,2,2,0,0,4,37,JH
JHARKHAND,2009,Professional Activity,0,6,9,5,0,20,0,1,1,0,0,2,22,JH
JHARKHAND,2009,Farming/Agriculture Activity,0,35,84,34,6,159,0,0,4,1,0,5,164,JH
JHARKHAND,2009,Retired Person,0,0,0,0,1,1,0,0,0,0,0,0,1,JH
JHARKHAND,2009,Total,16,203,272,202,51,744,22,135,124,64,23,368,1112,JH
JHARKHAND,2009,Total Salaried,0,23,83,33,1,140,2,17,4,1,0,24,164,JH
JHARKHAND,2009,Total Self-employed,1,82,128,66,12,289,1,10,17,6,0,34,323,JH
KARNATAKA,2009,Others (Please Specify),158,616,1245,1150,473,3642,129,314,395,409,156,1403,5045,KA
KARNATAKA,2009,House Wife,0,0,0,0,0,0,12,526,608,378,172,1696,1696,KA
KARNATAKA,2009,Service (Government),0,14,32,45,1,92,0,9,4,2,0,15,107,KA
KARNATAKA,2009,Service (Private),0,230,296,139,68,733,1,66,31,11,13,122,855,KA
KARNATAKA,2009,Public Sector Undertaking,0,115,72,42,15,244,0,18,16,12,2,48,292,KA
KARNATAKA,2009,Student,39,206,29,0,0,274,19,207,7,0,0,233,507,KA
KARNATAKA,2009,Unemployed,0,130,227,98,25,480,2,33,12,5,3,55,535,KA
KARNATAKA,2009,Self-employed (Business activity),0,151,234,224,27,636,0,9,13,7,1,30,666,KA
KARNATAKA,2009,Professional Activity,0,39,58,40,7,144,0,8,2,1,0,11,155,KA
KARNATAKA,2009,Farming/Agriculture Activity,6,318,705,590,296,1915,0,112,163,70,22,367,2282,KA
KARNATAKA,2009,Retired Person,0,0,5,3,41,49,0,4,1,0,1,6,55,KA
KARNATAKA,2009,Total,203,1819,2903,2331,953,8209,163,1306,1252,895,370,3986,12195,KA
KARNATAKA,2009,Total Salaried,0,359,400,226,84,1069,1,93,51,25,15,185,1254,KA
KARNATAKA,2009,Total Self-employed,25,857,1637,1501,633,4653,98,307,385,295,88,1173,5826,KA
KERALA,2009,Others (Please Specify),5,656,1012,1137,585,3395,0,192,117,122,107,538,3933,KL
KERALA,2009,House Wife,0,0,0,0,0,0,0,258,375,422,261,1316,1316,KL
KERALA,2009,Service (Government),0,7,24,25,1,57,0,3,6,6,0,15,72,KL
KERALA,2009,Service (Private),1,72,162,103,16,354,0,28,28,18,6,80,434,KL
KERALA,2009,Public Sector Undertaking,0,7,37,43,0,87,0,9,5,5,0,19,106,KL
KERALA,2009,Student,32,75,0,0,0,107,30,137,0,0,0,167,274,KL
KERALA,2009,Unemployed,0,130,220,134,136,620,0,55,57,22,49,183,803,KL
KERALA,2009,Self-employed (Business activity),0,80,194,222,90,586,0,1,5,6,0,12,598,KL
KERALA,2009,Professional Activity,0,48,73,68,24,213,0,3,5,7,0,15,228,KL
KERALA,2009,Farming/Agriculture Activity,0,116,252,294,158,820,0,19,18,23,16,76,896,KL
KERALA,2009,Retired Person,0,0,5,16,62,83,0,0,0,2,10,12,95,KL
KERALA,2009,Total,38,1191,1979,2042,1072,6322,30,705,616,633,449,2433,8755,KL
KERALA,2009,Total Salaried,1,86,223,171,17,498,0,40,39,29,6,114,612,KL
KERALA,2009,Total Self-employed,4,534,975,1063,506,3082,0,118,79,82,41,320,3402,KL
LAKSHADWEEP,2009,Others (Please Specify),0,0,0,0,0,0,0,0,0,0,0,0,0,LD
LAKSHADWEEP,2009,House Wife,0,0,0,0,0,0,0,0,1,0,0,1,1,LD
LAKSHADWEEP,2009,Service (Government),0,0,0,0,0,0,0,0,0,0,0,0,0,LD
LAKSHADWEEP,2009,Service (Private),0,0,0,0,0,0,0,0,0,0,0,0,0,LD
LAKSHADWEEP,2009,Public Sector Undertaking,0,0,0,0,0,0,0,0,0,0,0,0,0,LD
LAKSHADWEEP,2009,Student,0,0,0,0,0,0,0,0,0,0,0,0,0,LD
LAKSHADWEEP,2009,Unemployed,0,0,0,0,0,0,0,0,0,0,0,0,0,LD
LAKSHADWEEP,2009,Self-employed (Business activity),0,0,0,0,0,0,0,0,0,0,0,0,0,LD
LAKSHADWEEP,2009,Professional Activity,0,0,0,0,0,0,0,0,0,0,0,0,0,LD
LAKSHADWEEP,2009,Farming/Agriculture Activity,0,0,0,0,0,0,0,0,0,0,0,0,0,LD
LAKSHADWEEP,2009,Retired Person,0,0,0,0,0,0,0,0,0,0,0,0,0,LD
LAKSHADWEEP,2009,Total,0,0,0,0,0,0,0,0,1,0,0,1,1,LD
LAKSHADWEEP,2009,Total Salaried,0,0,0,0,0,0,0,0,0,0,0,0,0,LD
LAKSHADWEEP,2009,Total Self-employed,0,0,0,0,0,0,0,0,0,0,0,0,0,LD
MADHYA PRADESH,2009,Others (Please Specify),135,576,539,373,152,1775,157,353,328,105,71,1014,2789,MP
MADHYA PRADESH,2009,House Wife,0,0,0,0,0,0,11,1334,652,220,69,2286,2286,MP
MADHYA PRADESH,2009,Service (Government),0,13,15,16,0,44,0,1,4,8,0,13,57,MP
MADHYA PRADESH,2009,Service (Private),1,136,230,144,27,538,0,73,14,11,2,100,638,MP
MADHYA PRADESH,2009,Public Sector Undertaking,0,10,12,8,1,31,0,4,0,0,0,4,35,MP
MADHYA PRADESH,2009,Student,75,213,41,10,0,339,68,169,20,1,0,258,597,MP
MADHYA PRADESH,2009,Unemployed,6,160,94,34,7,301,0,16,5,1,0,22,323,MP
MADHYA PRADESH,2009,Self-employed (Business activity),23,136,185,165,72,581,0,8,13,2,0,23,604,MP
MADHYA PRADESH,2009,Professional Activity,20,96,111,97,32,356,0,11,4,3,0,18,374,MP
MADHYA PRADESH,2009,Farming/Agriculture Activity,6,418,354,239,103,1120,6,127,102,25,15,275,1395,MP
MADHYA PRADESH,2009,Retired Person,0,0,3,2,10,15,0,0,0,0,0,0,15,MP
MADHYA PRADESH,2009,Total,266,1758,1584,1088,404,5100,242,2096,1142,376,157,4013,9113,MP
MADHYA PRADESH,2009,Total Salaried,1,159,257,168,28,613,0,78,18,19,2,117,730,MP
MADHYA PRADESH,2009,Total Self-employed,64,947,901,644,287,2843,69,231,191,48,26,565,3408,MP
MAHARASHTRA,2009,Others (Please Specify),6,803,1063,624,337,2833,5,147,86,31,26,295,3128,MH
MAHARASHTRA,2009,House Wife,0,0,0,0,0,0,0,1656,1097,399,231,3383,3383,MH
MAHARASHTRA,2009,Service (Government),0,20,61,57,1,139,0,8,3,4,0,15,154,MH
MAHARASHTRA,2009,Service (Private),0,496,724,345,45,1610,0,78,33,8,1,120,1730,MH
MAHARASHTRA,2009,Public Sector Undertaking,0,37,74,38,2,151,0,7,3,2,0,12,163,MH
MAHARASHTRA,2009,Student,42,358,3,0,0,403,48,353,8,0,0,409,812,MH
MAHARASHTRA,2009,Unemployed,0,356,313,119,33,821,0,33,10,9,0,52,873,MH
MAHARASHTRA,2009,Self-employed (Business activity),0,112,165,108,27,412,0,3,4,0,0,7,419,MH
MAHARASHTRA,2009,Professional Activity,0,162,219,157,53,591,0,13,14,9,3,39,630,MH
MAHARASHTRA,2009,Farming/Agriculture Activity,0,557,1062,728,345,2692,2,89,36,40,13,180,2872,MH
MAHARASHTRA,2009,Retired Person,0,0,2,14,117,133,0,0,0,1,2,3,136,MH
MAHARASHTRA,2009,Total,48,2901,3686,2190,960,9785,55,2387,1294,503,276,4515,14300,MH
MAHARASHTRA,2009,Total Salaried,0,553,859,440,48,1900,0,93,39,14,1,147,2047,MH
MAHARASHTRA,2009,Total Self-employed,2,1554,2376,1569,705,6206,4,236,130,76,32,478,6684,MH
MANIPUR,2009,Others (Please Specify),0,0,5,0,0,5,0,2,0,0,0,2,7,MN
MANIPUR,2009,House Wife,0,0,0,0,0,0,0,3,2,0,0,5,5,MN
MANIPUR,2009,Service (Government),0,3,2,1,0,6,0,0,0,0,0,0,6,MN
MANIPUR,2009,Service (Private),0,0,0,0,0,0,0,0,0,0,0,0,0,MN
MANIPUR,2009,Public Sector Undertaking,0,0,0,0,0,0,0,0,0,0,0,0,0,MN
MANIPUR,2009,Student,0,0,0,0,0,0,0,0,0,0,0,0,0,MN
MANIPUR,2009,Unemployed,0,3,4,0,0,7,0,0,1,0,0,1,8,MN
MANIPUR,2009,Self-employed (Business activity),0,0,0,0,0,0,0,0,0,0,0,0,0,MN
MANIPUR,2009,Professional Activity,0,0,0,0,0,0,0,0,0,0,0,0,0,MN
MANIPUR,2009,Farming/Agriculture Activity,0,0,0,0,0,0,0,1,0,0,0,1,1,MN
MANIPUR,2009,Retired Person,0,0,0,0,0,0,0,0,0,0,0,0,0,MN
MANIPUR,2009,Total,0,6,11,1,0,18,0,6,3,0,0,9,27,MN
MANIPUR,2009,Total Salaried,0,3,2,1,0,6,0,0,0,0,0,0,6,MN
MANIPUR,2009,Total Self-employed,0,0,4,0,0,4,0,2,0,0,0,2,6,MN
MEGHALAYA,2009,Others (Please Specify),0,12,3,13,1,29,1,6,1,12,3,23,52,ML
MEGHALAYA,2009,House Wife,0,0,0,0,0,0,0,4,2,5,0,11,11,ML
MEGHALAYA,2009,Service (Government),0,0,0,1,0,1,0,0,0,0,0,0,1,ML
MEGHALAYA,2009,Service (Private),0,0,0,1,0,1,0,0,0,0,0,0,1,ML
MEGHALAYA,2009,Public Sector Undertaking,0,0,1,0,1,2,0,0,0,0,0,0,2,ML
MEGHALAYA,2009,Student,1,6,0,0,0,7,0,2,0,0,0,2,9,ML
MEGHALAYA,2009,Unemployed,0,2,4,0,0,6,0,1,0,0,0,1,7,ML
MEGHALAYA,2009,Self-employed (Business activity),0,1,1,1,0,3,0,0,0,0,0,0,3,ML
MEGHALAYA,2009,Professional Activity,0,0,0,0,0,0,0,0,3,0,0,3,3,ML
MEGHALAYA,2009,Farming/Agriculture Activity,0,3,2,10,1,16,0,5,0,0,0,5,21,ML
MEGHALAYA,2009,Retired Person,0,0,0,1,1,2,0,0,0,0,0,0,2,ML
MEGHALAYA,2009,Total,1,24,11,27,4,67,1,18,6,17,3,45,112,ML
MEGHALAYA,2009,Total Salaried,0,0,1,2,1,4,0,0,0,0,0,0,4,ML
MEGHALAYA,2009,Total Self-employed,0,5,4,11,1,21,1,8,3,0,0,12,33,ML
MIZORAM,2009,Others (Please Specify),0,12,4,2,0,18,0,1,0,0,0,1,19,MZ
MIZORAM,2009,House Wife,0,0,0,0,0,0,0,0,1,0,0,1,1,MZ
MIZORAM,2009,Service (Government),0,0,1,0,0,1,0,0,0,0,0,0,1,MZ
MIZORAM,2009,Service (Private),0,1,1,0,0,2,0,0,0,0,0,0,2,MZ
MIZORAM,2009,Public Sector Undertaking,0,0,0,0,0,0,0,0,0,0,0,0,0,MZ
MIZORAM,2009,Student,0,1,0,0,0,1,0,0,0,0,0,0,1,MZ
MIZORAM,2009,Unemployed,0,1,5,0,0,6,0,0,0,0,0,0,6,MZ
MIZORAM,2009,Self-employed (Business activity),0,0,0,0,0,0,0,0,0,0,0,0,0,MZ
MIZORAM,2009,Professional Activity,0,0,0,0,0,0,0,0,0,0,0,0,0,MZ
MIZORAM,2009,Farming/Agriculture Activity,1,16,14,1,1,33,0,2,1,2,0,5,38,MZ
MIZORAM,2009,Retired Person,0,0,0,1,0,1,0,0,0,0,0,0,1,MZ
MIZORAM,2009,Total,1,31,25,4,1,62,0,3,2,2,0,7,69,MZ
MIZORAM,2009,Total Salaried,0,1,2,0,0,3,0,0,0,0,0,0,3,MZ
MIZORAM,2009,Total Self-employed,1,22,18,3,1,45,0,3,1,2,0,6,51,MZ
NAGALAND,2009,Others (Please Specify),2,9,4,2,0,17,0,2,1,0,0,3,20,NG
NAGALAND,2009,House Wife,0,0,0,0,0,0,0,1,1,0,0,2,2,NG
NAGALAND,2009,Service (Government),0,1,2,2,0,5,0,0,0,0,0,0,5,NG
NAGALAND,2009,Service (Private),0,0,0,0,0,0,0,0,0,0,0,0,0,NG
NAGALAND,2009,Public Sector Undertaking,0,0,0,0,0,0,0,0,0,0,0,0,0,NG
NAGALAND,2009,Student,0,2,0,0,0,2,0,0,0,0,0,0,2,NG
NAGALAND,2009,Unemployed,0,0,0,0,0,0,0,0,0,0,0,0,0,NG
NAGALAND,2009,Self-employed (Business activity),0,0,1,0,0,1,0,0,0,0,0,0,1,NG
NAGALAND,2009,Professional Activity,0,0,0,0,0,0,0,0,0,0,0,0,0,NG
NAGALAND,2009,Farming/Agriculture Activity,0,0,0,0,0,0,0,1,0,0,0,1,1,NG
NAGALAND,2009,Retired Person,0,0,0,0,0,0,0,0,0,0,0,0,0,NG
NAGALAND,2009,Total,2,12,7,4,0,25,0,4,2,0,0,6,31,NG
NAGALAND,2009,Total Salaried,0,1,2,2,0,5,0,0,0,0,0,0,5,NG
NAGALAND,2009,Total Self-employed,0,8,4,1,0,13,0,2,1,0,0,3,16,NG
ODISHA,2009,Others (Please Specify),33,312,451,249,117,1162,31,272,235,117,49,704,1866,OD
ODISHA,2009,House Wife,0,0,0,0,0,0,0,254,261,92,20,627,627,OD
ODISHA,2009,Service (Government),0,9,6,17,1,33,0,8,2,1,0,11,44,OD
ODISHA,2009,Service (Private),0,83,93,45,17,238,0,53,35,13,0,101,339,OD
ODISHA,2009,Public Sector Undertaking,0,52,39,17,11,119,0,12,27,17,0,56,175,OD
ODISHA,2009,Student,20,140,1,0,0,161,26,105,1,0,0,132,293,OD
ODISHA,2009,Unemployed,16,133,139,75,11,374,10,66,19,17,2,114,488,OD
ODISHA,2009,Self-employed (Business activity),0,71,112,59,13,255,0,2,13,4,0,19,274,OD
ODISHA,2009,Professional Activity,0,11,17,9,0,37,0,5,3,0,3,11,48,OD
ODISHA,2009,Farming/Agriculture Activity,0,35,56,40,12,143,0,6,1,4,0,11,154,OD
ODISHA,2009,Retired Person,0,0,0,17,28,45,0,0,0,0,12,12,57,OD
ODISHA,2009,Total,69,846,914,528,210,2567,67,783,597,265,86,1798,4365,OD
ODISHA,2009,Total Salaried,0,144,138,79,29,390,0,73,64,31,0,168,558,OD
ODISHA,2009,Total Self-employed,20,346,473,288,95,1222,18,218,204,109,43,592,1814,OD
PUDUCHERRY,2009,Others (Please Specify),0,0,1,1,0,2,0,0,0,0,0,0,2,PY
PUDUCHERRY,2009,House Wife,0,0,0,0,0,0,0,50,32,23,6,111,111,PY
PUDUCHERRY,2009,Service (Government),0,2,3,6,0,11,0,0,1,0,0,1,12,PY
PUDUCHERRY,2009,Service (Private),0,7,10,1,1,19,0,12,1,0,0,13,32,PY
PUDUCHERRY,2009,Public Sector Undertaking,0,1,0,3,0,4,0,0,0,0,0,0,4,PY
PUDUCHERRY,2009,Student,2,7,0,0,0,9,4,13,0,0,0,17,26,PY
PUDUCHERRY,2009,Unemployed,0,16,14,20,26,76,0,24,4,2,7,37,113,PY
PUDUCHERRY,2009,Self-employed (Business activity),0,2,3,3,1,9,0,0,0,0,0,0,9,PY
PUDUCHERRY,2009,Professional Activity,0,18,18,13,0,49,0,2,2,1,0,5,54,PY
PUDUCHERRY,2009,Farming/Agriculture Activity,0,38,43,56,9,146,0,2,5,1,0,8,154,PY
PUDUCHERRY,2009,Retired Person,0,0,0,0,1,1,0,0,0,0,0,0,1,PY
PUDUCHERRY,2009,Total,2,91,92,103,38,326,4,103,45,27,13,192,518,PY
PUDUCHERRY,2009,Total Salaried,0,10,13,10,1,34,0,12,2,0,0,14,48,PY
PUDUCHERRY,2009,Total Self-employed,0,58,65,73,10,206,0,4,7,2,0,13,219,PY
PUNJAB,2009,Others (Please Specify),2,113,85,68,33,301,1,13,3,6,4,27,328,PN
PUNJAB,2009,House Wife,0,0,0,0,0,0,0,64,49,12,5,130,130,PN
PUNJAB,2009,Service (Government),0,1,13,1,0,15,0,0,0,0,0,0,15,PN
PUNJAB,2009,Service (Private),1,20,22,5,6,54,0,3,4,0,0,7,61,PN
PUNJAB,2009,Public Sector Undertaking,0,1,3,0,2,6,0,0,2,0,0,2,8,PN
PUNJAB,2009,Student,7,18,4,0,0,29,4,22,0,0,0,26,55,PN
PUNJAB,2009,Unemployed,0,20,20,2,1,43,0,3,2,0,0,5,48,PN
PUNJAB,2009,Self-employed (Business activity),1,12,22,13,3,51,0,0,0,0,2,2,53,PN
PUNJAB,2009,Professional Activity,0,5,11,15,0,31,0,0,1,0,0,1,32,PN
PUNJAB,2009,Farming/Agriculture Activity,0,38,35,14,6,93,0,2,0,2,0,4,97,PN
PUNJAB,2009,Retired Person,0,2,5,4,1,12,0,0,0,4,4,8,20,PN
PUNJAB,2009,Total,11,230,220,122,52,635,5,107,61,24,15,212,847,PN
PUNJAB,2009,Total Salaried,1,22,38,6,8,75,0,3,6,0,0,9,84,PN
PUNJAB,2009,Total Self-employed,3,128,120,77,23,351,0,6,3,4,3,16,367,PN
RAJASTHAN,2009,Others (Please Specify),55,515,522,346,101,1539,19,129,96,28,7,279,1818,RJ
RAJASTHAN,2009,House Wife,0,0,0,0,0,0,23,466,410,142,29,1070,1070,RJ
RAJASTHAN,2009,Service (Government),0,5,19,11,1,36,0,7,3,0,0,10,46,RJ
RAJASTHAN,2009,Service (Private),0,188,217,91,26,522,0,12,2,0,0,14,536,RJ
RAJASTHAN,2009,Public Sector Undertaking,0,2,5,9,4,20,0,1,1,1,0,3,23,RJ
RAJASTHAN,2009,Student,37,108,1,0,0,146,20,55,2,0,0,77,223,RJ
RAJASTHAN,2009,Unemployed,0,77,47,14,1,139,0,5,3,8,1,17,156,RJ
RAJASTHAN,2009,Self-employed (Business activity),0,61,158,54,4,277,0,2,2,2,0,6,283,RJ
RAJASTHAN,2009,Professional Activity,0,8,35,9,0,52,0,0,1,0,0,1,53,RJ
RAJASTHAN,2009,Farming/Agriculture Activity,7,196,337,190,45,775,0,33,28,12,3,76,851,RJ
RAJASTHAN,2009,Retired Person,0,0,1,1,3,5,0,0,0,0,1,1,6,RJ
RAJASTHAN,2009,Total,99,1160,1342,725,185,3511,62,710,548,193,41,1554,5065,RJ
RAJASTHAN,2009,Total Salaried,0,195,241,111,31,578,0,20,6,1,0,27,605,RJ
RAJASTHAN,2009,Total Self-employed,24,566,873,459,84,2006,13,102,84,24,6,229,2235,RJ
SIKKIM,2009,Others (Please Specify),3,13,3,1,1,21,3,7,2,0,0,12,33,SK
SIKKIM,2009,House Wife,0,0,0,0,0,0,0,5,3,0,0,8,8,SK
SIKKIM,2009,Service (Government),0,5,2,0,0,7,0,3,2,0,0,5,12,SK
SIKKIM,2009,Service (Private),0,7,3,2,1,13,0,7,4,4,3,18,31,SK
SIKKIM,2009,Public Sector Undertaking,0,3,5,3,0,11,0,8,5,3,0,16,27,SK
SIKKIM,2009,Student,0,5,0,0,0,5,0,2,0,0,0,2,7,SK
SIKKIM,2009,Unemployed,0,2,3,5,2,12,0,11,7,5,0,23,35,SK
SIKKIM,2009,Self-employed (Business activity),0,11,7,7,1,26,0,5,1,3,0,9,35,SK
SIKKIM,2009,Professional Activity,0,7,0,2,0,9,0,6,3,5,0,14,23,SK
SIKKIM,2009,Farming/Agriculture Activity,0,12,0,1,1,14,0,3,2,2,2,9,23,SK
SIKKIM,2009,Retired Person,0,0,0,2,2,4,0,0,0,1,2,3,7,SK
SIKKIM,2009,Total,3,65,23,23,8,122,3,57,29,23,7,119,241,SK
SIKKIM,2009,Total Salaried,0,15,10,5,1,31,0,18,11,7,3,39,70,SK
SIKKIM,2009,Total Self-employed,1,33,9,11,3,57,1,17,7,10,2,37,94,SK
TAMIL NADU,2009,Others (Please Specify),45,832,1092,783,478,3230,61,480,374,179,98,1192,4422,TN
TAMIL NADU,2009,House Wife,0,0,0,0,0,0,0,987,1017,492,267,2763,2763,TN
TAMIL NADU,2009,Service (Government),0,7,86,104,11,208,0,8,26,11,0,45,253,TN
TAMIL NADU,2009,Service (Private),0,393,604,308,54,1359,0,138,125,98,19,380,1739,TN
TAMIL NADU,2009,Public Sector Undertaking,0,152,136,48,9,345,0,4,12,11,0,27,372,TN
TAMIL NADU,2009,Student,83,174,0,0,0,257,68,131,0,0,0,199,456,TN
TAMIL NADU,2009,Unemployed,3,359,617,446,137,1562,6,171,83,140,24,424,1986,TN
TAMIL NADU,2009,Self-employed (Business activity),0,152,249,209,99,709,2,34,53,22,11,122,831,TN
TAMIL NADU,2009,Professional Activity,0,97,84,23,38,242,0,38,23,16,9,86,328,TN
TAMIL NADU,2009,Farming/Agriculture Activity,5,195,306,244,106,856,7,86,56,36,19,204,1060,TN
TAMIL NADU,2009,Retired Person,0,0,0,84,98,182,0,0,0,14,18,32,214,TN
TAMIL NADU,2009,Total,136,2361,3174,2249,1030,8950,144,2077,1769,1019,465,5474,14424,TN
TAMIL NADU,2009,Total Salaried,0,552,826,460,74,1912,0,150,163,120,19,452,2364,TN
TAMIL NADU,2009,Total Self-employed,32,929,1284,913,482,3640,35,355,347,156,88,981,4621,TN
TRIPURA,2009,Others (Please Specify),1,81,71,53,13,219,2,26,11,5,1,45,264,TR
TRIPURA,2009,House Wife,0,0,0,0,0,0,0,93,48,26,9,176,176,TR
TRIPURA,2009,Service (Government),0,5,9,5,0,19,0,0,0,0,0,0,19,TR
TRIPURA,2009,Service (Private),0,9,5,2,3,19,0,0,0,0,0,0,19,TR
TRIPURA,2009,Public Sector Undertaking,0,0,2,0,0,2,0,0,0,0,0,0,2,TR
TRIPURA,2009,Student,8,39,0,0,0,47,8,34,0,0,0,42,89,TR
TRIPURA,2009,Unemployed,0,22,3,0,0,25,0,1,3,0,0,4,29,TR
TRIPURA,2009,Self-employed (Business activity),0,15,38,18,0,71,0,4,0,0,0,4,75,TR
TRIPURA,2009,Professional Activity,0,5,10,4,1,20,0,0,0,0,0,0,20,TR
TRIPURA,2009,Farming/Agriculture Activity,0,11,16,13,5,45,0,0,0,0,0,0,45,TR
TRIPURA,2009,Retired Person,0,0,0,0,0,0,0,0,0,0,0,0,0,TR
TRIPURA,2009,Total,9,187,154,95,22,467,10,158,62,31,10,271,738,TR
TRIPURA,2009,Total Salaried,0,14,16,7,3,40,0,0,0,0,0,0,40,TR
TRIPURA,2009,Total Self-employed,0,80,120,86,18,304,1,29,9,0,0,39,343,TR
UTTAR PRADESH,2009,Others (Please Specify),19,233,206,156,86,700,25,201,135,43,24,428,1128,UP
UTTAR PRADESH,2009,House Wife,0,0,0,0,0,0,7,605,272,74,48,1006,1006,UP
UTTAR PRADESH,2009,Service (Government),0,10,15,6,0,31,0,11,4,3,0,18,49,UP
UTTAR PRADESH,2009,Service (Private),0,95,112,47,7,261,0,42,36,8,0,86,347,UP
UTTAR PRADESH,2009,Public Sector Undertaking,0,16,12,22,0,50,0,16,7,0,0,23,73,UP
UTTAR PRADESH,2009,Student,21,172,10,0,0,203,29,107,7,0,0,143,346,UP
UTTAR PRADESH,2009,Unemployed,5,135,118,48,13,319,1,21,20,7,3,52,371,UP
UTTAR PRADESH,2009,Self-employed (Business activity),0,45,31,38,12,126,0,6,10,2,0,18,144,UP
UTTAR PRADESH,2009,Professional Activity,0,7,8,5,1,21,0,1,1,0,0,2,23,UP
UTTAR PRADESH,2009,Farming/Agriculture Activity,6,121,253,96,48,524,0,59,28,24,21,132,656,UP
UTTAR PRADESH,2009,Retired Person,0,2,0,0,2,4,0,0,11,0,0,11,15,UP
UTTAR PRADESH,2009,Total,51,836,765,418,169,2239,62,1069,531,161,96,1919,4158,UP
UTTAR PRADESH,2009,Total Salaried,0,121,139,75,7,342,0,69,47,11,0,127,469,UP
UTTAR PRADESH,2009,Total Self-employed,14,321,435,257,129,1156,14,200,139,61,35,449,1605,UP
UTTARAKHAND,2009,Others (Please Specify),0,0,0,0,0,0,0,0,0,0,0,0,0,UK
UTTARAKHAND,2009,House Wife,0,0,0,0,0,0,0,42,25,7,1,75,75,UK
UTTARAKHAND,2009,Service (Government),0,3,1,4,0,8,0,0,0,0,0,0,8,UK
UTTARAKHAND,2009,Service (Private),0,15,9,9,0,33,0,2,4,0,0,6,39,UK
UTTARAKHAND,2009,Public Sector Undertaking,0,3,1,2,0,6,0,0,0,2,0,2,8,UK
UTTARAKHAND,2009,Student,1,20,0,0,0,21,3,16,0,0,0,19,40,UK
UTTARAKHAND,2009,Unemployed,0,10,16,5,0,31,0,4,1,0,0,5,36,UK
UTTARAKHAND,2009,Self-employed (Business activity),0,2,4,2,0,8,0,0,2,0,0,2,10,UK
UTTARAKHAND,2009,Professional Activity,0,2,8,14,3,27,0,5,2,0,0,7,34,UK
UTTARAKHAND,2009,Farming/Agriculture Activity,0,10,9,4,3,26,0,4,0,0,0,4,30,UK
UTTARAKHAND,2009,Retired Person,1,12,7,17,5,42,0,6,8,6,0,20,62,UK
UTTARAKHAND,2009,Total,2,77,55,57,11,202,3,79,42,15,1,140,342,UK
UTTARAKHAND,2009,Total Salaried,0,21,11,15,0,47,0,2,4,2,0,8,55,UK
UTTARAKHAND,2009,Total Self-employed,0,14,21,20,6,61,0,9,4,0,0,13,74,UK
WEST BENGAL,2009,Others (Please Specify),116,835,1263,729,293,3236,93,616,478,253,92,1532,4768,WB
WEST BENGAL,2009,House Wife,0,0,0,0,0,0,0,1495,1256,488,66,3305,3305,WB
WEST BENGAL,2009,Service (Government),0,32,94,53,0,179,0,19,26,14,1,60,239,WB
WEST BENGAL,2009,Service (Private),0,143,241,266,6,656,0,64,80,15,1,160,816,WB
WEST BENGAL,2009,Public Sector Undertaking,0,67,228,215,4,514,0,33,37,23,0,93,607,WB
WEST BENGAL,2009,Student,117,313,23,0,0,453,120,279,18,0,0,417,870,WB
WEST BENGAL,2009,Unemployed,1,448,591,108,3,1151,1,86,88,29,0,204,1355,WB
WEST BENGAL,2009,Self-employed (Business activity),0,290,471,333,44,1138,0,69,83,44,4,200,1338,WB
WEST BENGAL,2009,Professional Activity,0,23,96,59,2,180,0,15,13,0,0,28,208,WB
WEST BENGAL,2009,Farming/Agriculture Activity,1,256,402,217,53,929,4,49,52,18,2,125,1054,WB
WEST BENGAL,2009,Retired Person,0,0,0,0,58,58,0,0,0,0,30,30,88,WB
WEST BENGAL,2009,Total,235,2407,3409,1980,463,8494,218,2725,2131,884,196,6154,14648,WB
WEST BENGAL,2009,Total Salaried,0,242,563,534,10,1349,0,116,143,52,2,313,1662,WB
WEST BENGAL,2009,Total Self-employed,73,898,1693,921,166,3751,22,337,316,152,32,859,4610,WB
A & N ISLANDS,2010,Others (Please Specify),0,1,1,0,1,3,0,0,0,0,0,0,3,AN
A & N ISLANDS,2010,House Wife,0,0,0,0,0,0,0,15,11,2,3,31,31,AN
A & N ISLANDS,2010,Service (Government),0,3,8,7,0,18,0,1,0,0,0,1,19,AN
A & N ISLANDS,2010,Service (Private),0,16,19,10,3,48,0,2,0,0,0,2,50,AN
A & N ISLANDS,2010,Public Sector Undertaking,0,0,0,0,0,0,0,0,0,0,0,0,0,AN
A & N ISLANDS,2010,Student,4,4,0,0,0,8,0,6,0,0,0,6,14,AN
A & N ISLANDS,2010,Unemployed,0,13,0,0,0,13,0,4,0,0,0,4,17,AN
A & N ISLANDS,2010,Self-employed (Business activity),0,1,3,1,1,6,0,0,0,0,0,0,6,AN
A & N ISLANDS,2010,Professional Activity,0,0,0,0,0,0,0,0,0,0,0,0,0,AN
A & N ISLANDS,2010,Farming/Agriculture Activity,0,1,2,0,5,8,0,0,0,0,0,0,8,AN
A & N ISLANDS,2010,Retired Person,0,0,0,0,8,8,0,0,0,0,0,0,8,AN
A & N ISLANDS,2010,Total,4,39,33,18,18,112,0,28,11,2,3,44,156,AN
A & N ISLANDS,2010,Total Salaried,0,19,27,17,3,66,0,3,0,0,0,3,69,AN
A & N ISLANDS,2010,Total Self-employed,0,2,6,1,7,16,0,0,0,0,0,0,16,AN
ANDHRA PRADESH,2010,Others (Please Specify),50,1411,1743,1322,534,5060,56,509,409,186,122,1282,6342,AP
ANDHRA PRADESH,2010,House Wife,0,0,0,0,0,0,0,1067,879,409,246,2601,2601,AP
ANDHRA PRADESH,2010,Service (Government),0,39,96,52,0,187,0,41,31,0,0,72,259,AP
ANDHRA PRADESH,2010,Service (Private),0,352,361,198,18,929,0,58,36,11,9,114,1043,AP
ANDHRA PRADESH,2010,Public Sector Undertaking,0,156,184,96,49,485,0,9,29,9,0,47,532,AP
ANDHRA PRADESH,2010,Student,41,333,0,0,0,374,62,220,0,0,0,282,656,AP
ANDHRA PRADESH,2010,Unemployed,0,266,208,87,0,561,0,27,48,0,0,75,636,AP
ANDHRA PRADESH,2010,Self-employed (Business activity),0,324,371,192,50,937,0,43,2,10,3,58,995,AP
ANDHRA PRADESH,2010,Professional Activity,0,86,75,37,20,218,0,6,1,2,1,10,228,AP
ANDHRA PRADESH,2010,Farming/Agriculture Activity,4,563,824,573,166,2130,12,165,137,40,41,395,2525,AP
ANDHRA PRADESH,2010,Retired Person,0,0,0,9,57,66,0,0,0,11,7,18,84,AP
ANDHRA PRADESH,2010,Total,95,3530,3862,2566,894,10947,130,2145,1572,678,429,4954,15901,AP
ANDHRA PRADESH,2010,Total Salaried,0,547,641,346,67,1601,0,108,96,20,9,233,1834,AP
ANDHRA PRADESH,2010,Total Self-employed,36,1936,2486,1696,604,6758,41,557,327,164,121,1210,7968,AP
ARUNACHAL PRADESH,2010,Others (Please Specify),0,21,10,3,1,35,0,12,0,1,0,13,48,AR
ARUNACHAL PRADESH,2010,House Wife,0,0,0,0,0,0,0,9,7,1,0,17,17,AR
ARUNACHAL PRADESH,2010,Service (Government),0,6,4,1,0,11,0,0,0,0,0,0,11,AR
ARUNACHAL PRADESH,2010,Service (Private),0,3,5,1,0,9,0,0,1,0,0,1,10,AR
ARUNACHAL PRADESH,2010,Public Sector Undertaking,0,0,0,0,0,0,0,0,0,0,0,0,0,AR
ARUNACHAL PRADESH,2010,Student,4,4,0,0,0,8,4,4,0,0,0,8,16,AR
ARUNACHAL PRADESH,2010,Unemployed,0,2,4,0,0,6,0,1,0,0,0,1,7,AR
ARUNACHAL PRADESH,2010,Self-employed (Business activity),0,4,0,0,0,4,0,0,0,0,0,0,4,AR
ARUNACHAL PRADESH,2010,Professional Activity,0,0,0,0,0,0,0,0,0,0,0,0,0,AR
ARUNACHAL PRADESH,2010,Farming/Agriculture Activity,0,7,9,1,1,18,0,0,0,0,0,0,18,AR
ARUNACHAL PRADESH,2010,Retired Person,0,0,0,0,0,0,0,0,0,0,0,0,0,AR
ARUNACHAL PRADESH,2010,Total,4,47,32,6,2,91,4,26,8,2,0,40,131,AR
ARUNACHAL PRADESH,2010,Total Salaried,0,9,9,2,0,20,0,0,1,0,0,1,21,AR
ARUNACHAL PRADESH,2010,Total Self-employed,0,15,13,4,2,34,0,0,0,0,0,0,34,AR
ASSAM,2010,Others (Please Specify),14,271,285,155,45,770,18,124,102,47,12,303,1073,AS
ASSAM,2010,House Wife,0,0,0,0,0,0,0,205,146,55,9,415,415,AS
ASSAM,2010,Service (Government),0,2,7,9,0,18,0,1,0,0,0,1,19,AS
ASSAM,2010,Service (Private),0,19,28,10,0,57,0,11,5,0,0,16,73,AS
ASSAM,2010,Public Sector Undertaking,0,19,51,26,2,98,0,2,12,6,0,20,118,AS
ASSAM,2010,Student,20,128,0,0,0,148,14,85,0,0,0,99,247,AS
ASSAM,2010,Unemployed,0,3,28,34,1,66,0,12,2,2,0,16,82,AS
ASSAM,2010,Self-employed (Business activity),0,112,163,95,1,371,0,36,23,11,0,70,441,AS
ASSAM,2010,Professional Activity,0,59,45,29,3,136,0,7,3,0,0,10,146,AS
ASSAM,2010,Farming/Agriculture Activity,0,132,126,82,12,352,0,6,9,1,1,17,369,AS
ASSAM,2010,Retired Person,0,0,2,2,6,10,0,0,0,0,0,0,10,AS
ASSAM,2010,Total,34,745,735,442,70,2026,32,489,302,122,22,967,2993,AS
ASSAM,2010,Total Salaried,0,40,86,45,2,173,0,14,17,6,0,37,210,AS
ASSAM,2010,Total Self-employed,9,492,553,318,52,1424,8,145,118,54,10,335,1759,AS
BIHAR,2010,Others (Please Specify),28,107,174,97,29,435,35,122,44,23,10,234,669,BR
BIHAR,2010,House Wife,0,0,0,0,0,0,0,80,89,26,9,204,204,BR
BIHAR,2010,Service (Government),0,6,5,2,0,13,0,2,6,0,0,8,21,BR
BIHAR,2010,Service (Private),0,23,12,5,1,41,2,2,3,1,0,8,49,BR
BIHAR,2010,Public Sector Undertaking,0,2,0,0,0,2,0,0,0,0,0,0,2,BR
BIHAR,2010,Student,12,21,6,0,0,39,14,13,8,0,0,35,74,BR
BIHAR,2010,Unemployed,0,36,28,9,0,73,3,3,6,3,0,15,88,BR
BIHAR,2010,Self-employed (Business activity),0,4,6,2,0,12,0,2,2,0,0,4,16,BR
BIHAR,2010,Professional Activity,0,2,2,1,0,5,0,0,0,0,0,0,5,BR
BIHAR,2010,Farming/Agriculture Activity,0,27,39,20,5,91,0,3,1,0,0,4,95,BR
BIHAR,2010,Retired Person,0,0,0,0,1,1,0,0,0,0,2,2,3,BR
BIHAR,2010,Total,40,228,272,136,36,712,54,227,159,53,21,514,1226,BR
BIHAR,2010,Total Salaried,0,31,17,7,1,56,2,4,9,1,0,16,72,BR
BIHAR,2010,Total Self-employed,12,82,155,103,20,372,7,22,28,2,0,59,431,BR
CHANDIGARH,2010,Others (Please Specify),0,0,4,1,0,5,1,6,0,0,0,7,12,CH
CHANDIGARH,2010,House Wife,0,0,0,0,0,0,0,6,10,2,1,19,19,CH
CHANDIGARH,2010,Service (Government),0,1,2,0,0,3,0,1,0,0,0,1,4,CH
CHANDIGARH,2010,Service (Private),0,4,4,2,0,10,0,0,0,0,0,0,10,CH
CHANDIGARH,2010,Public Sector Undertaking,0,1,0,1,0,2,0,0,0,0,0,0,2,CH
CHANDIGARH,2010,Student,0,4,0,0,0,4,1,9,0,0,0,10,14,CH
CHANDIGARH,2010,Unemployed,0,4,1,0,0,5,0,3,0,0,0,3,8,CH
CHANDIGARH,2010,Self-employed (Business activity),0,0,1,0,0,1,0,0,0,0,0,0,1,CH
CHANDIGARH,2010,Professional Activity,0,0,0,0,0,0,0,0,0,0,0,0,0,CH
CHANDIGARH,2010,Farming/Agriculture Activity,0,0,0,0,0,0,0,0,0,0,0,0,0,CH
CHANDIGARH,2010,Retired Person,0,0,0,0,1,1,0,0,0,0,0,0,1,CH
CHANDIGARH,2010,Total,0,14,12,4,1,31,2,25,10,2,1,40,71,CH
CHANDIGARH,2010,Total Salaried,0,6,6,3,0,15,0,1,0,0,0,1,16,CH
CHANDIGARH,2010,Total Self-employed,0,0,5,1,0,6,1,5,0,0,0,6,12,CH
CHHATTISGARH,2010,Others (Please Specify),56,566,691,636,303,2252,28,179,192,94,45,538,2790,CG
CHHATTISGARH,2010,House Wife,0,0,0,0,0,0,2,453,286,91,30,862,862,CG
CHHATTISGARH,2010,Service (Government),0,8,16,14,0,38,0,1,0,1,0,2,40,CG
CHHATTISGARH,2010,Service (Private),0,127,103,55,2,287,0,22,18,2,2,44,331,CG
CHHATTISGARH,2010,Public Sector Undertaking,0,16,13,15,0,44,0,0,0,0,0,0,44,CG
CHHATTISGARH,2010,Student,47,166,9,1,0,223,24,125,5,0,0,154,377,CG
CHHATTISGARH,2010,Unemployed,4,177,306,104,2,593,2,13,4,0,0,19,612,CG
CHHATTISGARH,2010,Self-employed (Business activity),0,42,31,18,7,98,0,2,4,0,0,6,104,CG
CHHATTISGARH,2010,Professional Activity,0,86,95,40,10,231,0,2,1,1,0,4,235,CG
CHHATTISGARH,2010,Farming/Agriculture Activity,3,196,274,219,86,778,2,65,137,103,41,348,1126,CG
CHHATTISGARH,2010,Retired Person,0,0,0,0,1,1,0,0,0,0,0,0,1,CG
CHHATTISGARH,2010,Total,110,1384,1538,1102,411,4545,58,862,647,292,118,1977,6522,CG
CHHATTISGARH,2010,Total Salaried,0,151,132,84,2,369,0,23,18,3,2,46,415,CG
CHHATTISGARH,2010,Total Self-employed,3,618,823,688,278,2410,7,162,255,151,67,642,3052,CG
D & N HAVELI,2010,Others (Please Specify),0,5,2,2,5,14,0,0,0,0,0,0,14,DN
D & N HAVELI,2010,House Wife,0,0,0,0,0,0,0,15,4,4,0,23,23,DN
D & N HAVELI,2010,Service (Government),0,1,0,0,0,1,0,0,0,0,0,0,1,DN
D & N HAVELI,2010,Service (Private),0,6,5,1,0,12,0,0,0,0,0,0,12,DN
D & N HAVELI,2010,Public Sector Undertaking,0,0,0,0,0,0,0,0,0,0,0,0,0,DN
D & N HAVELI,2010,Student,0,0,0,0,0,0,0,3,0,0,0,3,3,DN
D & N HAVELI,2010,Unemployed,0,0,0,0,0,0,0,0,0,0,0,0,0,DN
D & N HAVELI,2010,Self-employed (Business activity),0,0,0,0,0,0,0,0,0,0,0,0,0,DN
D & N HAVELI,2010,Professional Activity,0,0,0,0,0,0,0,0,0,0,0,0,0,DN
D & N HAVELI,2010,Farming/Agriculture Activity,0,2,5,3,0,10,0,0,0,0,0,0,10,DN
D & N HAVELI,2010,Retired Person,0,0,0,0,0,0,0,0,0,0,0,0,0,DN
D & N HAVELI,2010,Total,0,14,12,6,5,37,0,18,4,4,0,26,63,DN
D & N HAVELI,2010,Total Salaried,0,7,5,1,0,13,0,0,0,0,0,0,13,DN
D & N HAVELI,2010,Total Self-employed,0,3,5,3,0,11,0,0,0,0,0,0,11,DN
DAMAN & DIU,2010,Others (Please Specify),0,2,0,1,0,3,0,2,0,0,0,2,5,DD
DAMAN & DIU,2010,House Wife,0,0,0,0,0,0,0,6,2,0,0,8,8,DD
DAMAN & DIU,2010,Service (Government),0,0,1,0,0,1,0,0,0,0,0,0,1,DD
DAMAN & DIU,2010,Service (Private),0,4,5,1,0,10,0,1,0,0,0,1,11,DD
DAMAN & DIU,2010,Public Sector Undertaking,0,0,0,0,0,0,0,0,0,0,0,0,0,DD
DAMAN & DIU,2010,Student,3,2,0,0,0,5,0,1,0,0,0,1,6,DD
DAMAN & DIU,2010,Unemployed,0,0,0,0,0,0,0,0,0,0,0,0,0,DD
DAMAN & DIU,2010,Self-employed (Business activity),0,0,0,0,0,0,0,0,0,0,0,0,0,DD
DAMAN & DIU,2010,Professional Activity,0,0,0,0,0,0,0,0,0,0,0,0,0,DD
DAMAN & DIU,2010,Farming/Agriculture Activity,0,0,0,0,0,0,0,0,0,0,0,0,0,DD
DAMAN & DIU,2010,Retired Person,0,0,0,0,0,0,0,0,0,0,0,0,0,DD
DAMAN & DIU,2010,Total,3,8,6,2,0,19,0,10,2,0,0,12,31,DD
DAMAN & DIU,2010,Total Salaried,0,4,6,1,0,11,0,1,0,0,0,1,12,DD
DAMAN & DIU,2010,Total Self-employed,0,0,0,0,0,0,0,0,0,0,0,0,0,DD
DELHI (UT),2010,Others (Please Specify),5,132,124,58,16,335,3,52,18,2,2,77,412,DL
DELHI (UT),2010,House Wife,0,0,0,0,0,0,0,197,117,31,7,352,352,DL
DELHI (UT),2010,Service (Government),0,2,7,6,0,15,0,3,0,0,0,3,18,DL
DELHI (UT),2010,Service (Private),0,90,78,22,11,201,0,18,3,1,0,22,223,DL
DELHI (UT),2010,Public Sector Undertaking,0,12,23,4,0,39,0,5,0,0,0,5,44,DL
DELHI (UT),2010,Student,11,75,1,0,0,87,18,56,3,2,0,79,166,DL
DELHI (UT),2010,Unemployed,0,102,88,30,16,236,3,32,8,0,0,43,279,DL
DELHI (UT),2010,Self-employed (Business activity),0,13,11,8,0,32,0,0,0,0,0,0,32,DL
DELHI (UT),2010,Professional Activity,0,1,2,0,0,3,0,0,1,0,0,1,4,DL
DELHI (UT),2010,Farming/Agriculture Activity,0,2,5,2,0,9,0,0,0,0,0,0,9,DL
DELHI (UT),2010,Retired Person,0,0,0,0,4,4,0,0,0,0,0,0,4,DL
DELHI (UT),2010,Total,16,429,339,130,47,961,24,363,150,36,9,582,1543,DL
DELHI (UT),2010,Total Salaried,0,104,108,32,11,255,0,26,3,1,0,30,285,DL
DELHI (UT),2010,Total Self-employed,0,79,87,44,10,220,0,29,7,1,1,38,258,DL
GOA,2010,Others (Please Specify),0,14,18,25,7,64,0,5,1,0,5,11,75,GA
GOA,2010,House Wife,0,0,0,0,0,0,0,14,18,9,11,52,52,GA
GOA,2010,Service (Government),0,1,4,4,0,9,0,0,0,0,0,0,9,GA
GOA,2010,Service (Private),0,24,31,11,1,67,0,3,0,0,0,3,70,GA
GOA,2010,Public Sector Undertaking,0,1,1,0,0,2,0,0,0,0,0,0,2,GA
GOA,2010,Student,2,10,1,0,0,13,2,8,0,0,0,10,23,GA
GOA,2010,Unemployed,0,15,19,14,3,51,1,7,2,0,0,10,61,GA
GOA,2010,Self-employed (Business activity),0,2,4,5,0,11,0,0,0,0,0,0,11,GA
GOA,2010,Professional Activity,0,0,0,1,0,1,0,0,0,0,0,0,1,GA
GOA,2010,Farming/Agriculture Activity,0,2,3,3,7,15,0,0,0,0,0,0,15,GA
GOA,2010,Retired Person,0,0,0,0,3,3,0,0,0,0,0,0,3,GA
GOA,2010,Total,2,69,81,63,21,236,3,37,21,9,16,86,322,GA
GOA,2010,Total Salaried,0,26,36,15,1,78,0,3,0,0,0,3,81,GA
GOA,2010,Total Self-employed,0,9,12,13,11,45,0,0,0,0,0,0,45,GA
GUJARAT,2010,Others (Please Specify),13,368,397,278,89,1145,15,124,92,50,25,306,1451,GJ
GUJARAT,2010,House Wife,0,0,0,0,0,0,2,726,512,253,82,1575,1575,GJ
GUJARAT,2010,Service (Government),0,17,31,14,0,62,0,6,5,2,0,13,75,GJ
GUJARAT,2010,Service (Private),0,197,202,116,9,524,0,42,44,11,1,98,622,GJ
GUJARAT,2010,Public Sector Undertaking,0,23,31,20,3,77,0,11,7,6,0,24,101,GJ
GUJARAT,2010,Student,19,125,6,1,0,151,18,121,3,0,0,142,293,GJ
GUJARAT,2010,Unemployed,1,217,231,81,18,548,0,39,17,5,0,61,609,GJ
GUJARAT,2010,Self-employed (Business activity),1,151,185,70,21,428,6,8,12,11,2,39,467,GJ
GUJARAT,2010,Professional Activity,2,116,127,63,13,321,0,10,5,4,0,19,340,GJ
GUJARAT,2010,Farming/Agriculture Activity,1,127,201,104,25,458,1,18,25,17,4,65,523,GJ
GUJARAT,2010,Retired Person,0,2,1,11,85,99,0,0,0,8,44,52,151,GJ
GUJARAT,2010,Total,37,1343,1412,758,263,3813,42,1105,722,367,158,2394,6207,GJ
GUJARAT,2010,Total Salaried,0,237,264,150,12,663,0,59,56,19,1,135,798,GJ
GUJARAT,2010,Total Self-employed,7,587,716,405,91,1806,11,94,76,58,14,253,2059,GJ
HARYANA,2010,Others (Please Specify),9,371,392,247,76,1095,8,49,79,48,10,194,1289,HR
HARYANA,2010,House Wife,0,0,0,0,0,0,0,174,124,50,16,364,364,HR
HARYANA,2010,Service (Government),0,14,16,10,0,40,0,24,18,3,0,45,85,HR
HARYANA,2010,Service (Private),0,78,72,42,2,194,0,18,7,2,0,27,221,HR
HARYANA,2010,Public Sector Undertaking,0,8,2,1,0,11,1,4,0,0,0,5,16,HR
HARYANA,2010,Student,12,101,6,0,0,119,8,21,0,0,0,29,148,HR
HARYANA,2010,Unemployed,3,143,118,67,16,347,0,21,9,4,3,37,384,HR
HARYANA,2010,Self-employed (Business activity),0,16,12,16,2,46,0,0,0,0,0,0,46,HR
HARYANA,2010,Professional Activity,0,14,17,13,1,45,0,0,0,0,0,0,45,HR
HARYANA,2010,Farming/Agriculture Activity,0,94,103,59,25,281,0,9,5,2,0,16,297,HR
HARYANA,2010,Retired Person,0,0,0,0,0,0,0,0,0,0,0,0,0,HR
HARYANA,2010,Total,24,839,738,455,122,2178,17,320,242,109,29,717,2895,HR
HARYANA,2010,Total Salaried,0,100,90,53,2,245,1,46,25,5,0,77,322,HR
HARYANA,2010,Total Self-employed,2,314,315,221,73,925,5,20,25,11,5,66,991,HR
HIMACHAL PRADESH,2010,Others (Please Specify),1,26,38,15,7,87,0,14,17,11,4,46,133,HP
HIMACHAL PRADESH,2010,House Wife,0,0,0,0,0,0,0,44,24,15,5,88,88,HP
HIMACHAL PRADESH,2010,Service (Government),0,2,7,11,0,20,0,1,1,1,0,3,23,HP
HIMACHAL PRADESH,2010,Service (Private),0,10,17,9,2,38,0,4,2,1,0,7,45,HP
HIMACHAL PRADESH,2010,Public Sector Undertaking,0,3,6,2,1,12,0,2,1,2,1,6,18,HP
HIMACHAL PRADESH,2010,Student,7,26,0,0,0,33,4,27,2,0,0,33,66,HP
HIMACHAL PRADESH,2010,Unemployed,0,24,23,4,1,52,0,2,1,0,0,3,55,HP
HIMACHAL PRADESH,2010,Self-employed (Business activity),0,4,5,7,3,19,0,1,2,1,1,5,24,HP
HIMACHAL PRADESH,2010,Professional Activity,0,10,4,6,1,21,0,0,1,0,0,1,22,HP
HIMACHAL PRADESH,2010,Farming/Agriculture Activity,0,12,24,15,8,59,0,2,0,0,0,2,61,HP
HIMACHAL PRADESH,2010,Retired Person,0,0,1,4,2,7,0,0,0,0,0,0,7,HP
HIMACHAL PRADESH,2010,Total,8,117,125,73,25,348,4,97,51,31,11,194,542,HP
HIMACHAL PRADESH,2010,Total Salaried,0,15,30,22,3,70,0,7,4,4,1,16,86,HP
HIMACHAL PRADESH,2010,Total Self-employed,0,40,48,35,13,136,0,10,10,6,4,30,166,HP
JAMMU & KASHMIR,2010,Others (Please Specify),0,13,4,10,4,31,0,29,7,2,1,39,70,JK
JAMMU & KASHMIR,2010,House Wife,0,0,0,0,0,0,0,30,24,4,0,58,58,JK
JAMMU & KASHMIR,2010,Service (Government),0,2,2,0,0,4,0,1,1,0,0,2,6,JK
JAMMU & KASHMIR,2010,Service (Private),0,1,9,3,0,13,0,0,0,0,0,0,13,JK
JAMMU & KASHMIR,2010,Public Sector Undertaking,0,1,1,0,0,2,0,0,0,0,0,0,2,JK
JAMMU & KASHMIR,2010,Student,3,11,3,0,0,17,2,12,3,2,0,19,36,JK
JAMMU & KASHMIR,2010,Unemployed,0,12,11,4,0,27,1,12,3,0,0,16,43,JK
JAMMU & KASHMIR,2010,Self-employed (Business activity),0,1,2,4,2,9,0,0,0,0,0,0,9,JK
JAMMU & KASHMIR,2010,Professional Activity,0,2,0,0,0,2,0,0,1,0,0,1,3,JK
JAMMU & KASHMIR,2010,Farming/Agriculture Activity,0,3,8,4,1,16,0,2,0,0,0,2,18,JK
JAMMU & KASHMIR,2010,Retired Person,0,0,0,1,0,1,0,0,0,0,0,0,1,JK
JAMMU & KASHMIR,2010,Total,3,46,40,26,7,122,3,86,39,8,1,137,259,JK
JAMMU & KASHMIR,2010,Total Salaried,0,4,12,3,0,19,0,1,1,0,0,2,21,JK
JAMMU & KASHMIR,2010,Total Self-employed,0,11,11,11,6,39,0,9,3,0,0,12,51,JK
JHARKHAND,2010,Others (Please Specify),38,68,121,86,4,317,6,51,21,22,20,120,437,JH
JHARKHAND,2010,House Wife,0,0,0,0,0,0,1,52,104,51,4,212,212,JH
JHARKHAND,2010,Service (Government),0,1,3,4,0,8,0,0,1,1,0,2,10,JH
JHARKHAND,2010,Service (Private),0,20,29,28,0,77,0,5,3,2,0,10,87,JH
JHARKHAND,2010,Public Sector Undertaking,18,1,2,3,0,24,0,4,0,0,0,4,28,JH
JHARKHAND,2010,Student,18,70,4,0,0,92,9,40,1,0,0,50,142,JH
JHARKHAND,2010,Unemployed,0,34,41,13,0,88,0,8,4,0,0,12,100,JH
JHARKHAND,2010,Self-employed (Business activity),0,8,13,6,0,27,0,2,2,0,0,4,31,JH
JHARKHAND,2010,Professional Activity,0,3,4,2,0,9,0,0,0,0,0,0,9,JH
JHARKHAND,2010,Farming/Agriculture Activity,10,47,58,30,5,150,0,13,6,4,0,23,173,JH
JHARKHAND,2010,Retired Person,0,0,0,0,3,3,0,0,0,0,0,0,3,JH
JHARKHAND,2010,Total,84,252,275,172,12,795,16,175,142,80,24,437,1232,JH
JHARKHAND,2010,Total Salaried,18,22,34,35,0,109,0,9,4,3,0,16,125,JH
JHARKHAND,2010,Total Self-employed,12,91,139,69,7,318,0,48,17,19,5,89,407,JH
KARNATAKA,2010,Others (Please Specify),39,696,1156,899,441,3231,66,355,306,304,162,1193,4424,KA
KARNATAKA,2010,House Wife,0,0,0,0,0,0,2,703,664,361,159,1889,1889,KA
KARNATAKA,2010,Service (Government),0,37,60,65,16,178,0,17,17,4,2,40,218,KA
KARNATAKA,2010,Service (Private),0,244,377,204,64,889,0,124,71,23,9,227,1116,KA
KARNATAKA,2010,Public Sector Undertaking,0,85,79,58,32,254,0,15,12,14,0,41,295,KA
KARNATAKA,2010,Student,43,238,9,22,7,319,89,176,7,0,0,272,591,KA
KARNATAKA,2010,Unemployed,0,125,122,95,20,362,0,35,21,2,0,58,420,KA
KARNATAKA,2010,Self-employed (Business activity),0,234,303,227,81,845,0,13,15,11,4,43,888,KA
KARNATAKA,2010,Professional Activity,2,30,34,38,6,110,0,5,7,3,0,15,125,KA
KARNATAKA,2010,Farming/Agriculture Activity,3,381,723,751,270,2128,11,159,128,111,48,457,2585,KA
KARNATAKA,2010,Retired Person,0,0,2,29,60,91,0,0,0,2,7,9,100,KA
KARNATAKA,2010,Total,87,2070,2865,2388,997,8407,168,1602,1248,835,391,4244,12651,KA
KARNATAKA,2010,Total Salaried,0,366,516,327,112,1321,0,156,100,41,11,308,1629,KA
KARNATAKA,2010,Total Self-employed,25,1150,1821,1560,556,5112,38,411,318,286,99,1152,6264,KA
KERALA,2010,Others (Please Specify),7,530,1040,1198,530,3305,1,80,124,117,76,398,3703,KL
KERALA,2010,House Wife,0,0,0,0,0,0,0,270,370,349,230,1219,1219,KL
KERALA,2010,Service (Government),0,7,28,27,0,62,0,1,5,3,0,9,71,KL
KERALA,2010,Service (Private),0,66,149,158,7,380,0,28,33,13,0,74,454,KL
KERALA,2010,Public Sector Undertaking,0,23,59,52,2,136,0,4,4,4,0,12,148,KL
KERALA,2010,Student,56,72,1,0,0,129,44,140,0,0,0,184,313,KL
KERALA,2010,Unemployed,1,162,248,214,207,832,1,52,55,32,70,210,1042,KL
KERALA,2010,Self-employed (Business activity),0,57,148,163,96,464,0,1,3,9,2,15,479,KL
KERALA,2010,Professional Activity,0,25,56,81,13,175,0,4,5,1,1,11,186,KL
KERALA,2010,Farming/Agriculture Activity,0,98,242,264,193,797,0,28,26,14,30,98,895,KL
KERALA,2010,Retired Person,0,0,2,14,50,66,0,0,1,2,7,10,76,KL
KERALA,2010,Total,64,1040,1973,2171,1098,6346,46,608,626,544,416,2240,8586,KL
KERALA,2010,Total Salaried,0,96,236,237,9,578,0,33,42,20,0,95,673,KL
KERALA,2010,Total Self-employed,4,441,999,1137,650,3231,1,76,104,71,64,316,3547,KL
LAKSHADWEEP,2010,Others (Please Specify),0,0,0,0,0,0,0,0,0,0,0,0,0,LD
LAKSHADWEEP,2010,House Wife,0,0,0,0,0,0,0,0,1,0,0,1,1,LD
LAKSHADWEEP,2010,Service (Government),0,0,0,0,0,0,0,0,0,0,0,0,0,LD
LAKSHADWEEP,2010,Service (Private),0,0,0,0,0,0,0,0,0,0,0,0,0,LD
LAKSHADWEEP,2010,Public Sector Undertaking,0,0,0,0,0,0,0,0,0,0,0,0,0,LD
LAKSHADWEEP,2010,Student,0,0,0,0,0,0,0,0,0,0,0,0,0,LD
LAKSHADWEEP,2010,Unemployed,0,0,0,0,0,0,0,0,0,0,0,0,0,LD
LAKSHADWEEP,2010,Self-employed (Business activity),0,0,0,0,0,0,0,0,0,0,0,0,0,LD
LAKSHADWEEP,2010,Professional Activity,0,0,0,0,0,0,0,0,0,0,0,0,0,LD
LAKSHADWEEP,2010,Farming/Agriculture Activity,0,0,0,0,0,0,0,0,0,0,0,0,0,LD
LAKSHADWEEP,2010,Retired Person,0,0,0,0,0,0,0,0,0,0,0,0,0,LD
LAKSHADWEEP,2010,Total,0,0,0,0,0,0,0,0,1,0,0,1,1,LD
LAKSHADWEEP,2010,Total Salaried,0,0,0,0,0,0,0,0,0,0,0,0,0,LD
LAKSHADWEEP,2010,Total Self-employed,0,0,0,0,0,0,0,0,0,0,0,0,0,LD
MADHYA PRADESH,2010,Others (Please Specify),115,788,729,452,203,2287,65,350,161,91,46,713,3000,MP
MADHYA PRADESH,2010,House Wife,0,0,0,0,0,0,18,1366,815,255,110,2564,2564,MP
MADHYA PRADESH,2010,Service (Government),0,19,48,29,6,102,0,3,5,4,0,12,114,MP
MADHYA PRADESH,2010,Service (Private),0,149,108,66,21,344,2,24,18,8,6,58,402,MP
MADHYA PRADESH,2010,Public Sector Undertaking,0,39,64,15,13,131,0,6,3,2,4,15,146,MP
MADHYA PRADESH,2010,Student,73,175,8,12,0,268,51,135,5,0,0,191,459,MP
MADHYA PRADESH,2010,Unemployed,10,133,111,42,12,308,8,44,12,2,0,66,374,MP
MADHYA PRADESH,2010,Self-employed (Business activity),0,112,145,89,25,371,0,0,0,0,0,0,371,MP
MADHYA PRADESH,2010,Professional Activity,0,93,97,73,29,292,3,10,12,3,0,28,320,MP
MADHYA PRADESH,2010,Farming/Agriculture Activity,17,282,357,208,109,973,14,132,74,27,17,264,1237,MP
MADHYA PRADESH,2010,Retired Person,0,0,1,4,6,11,0,5,0,0,0,5,16,MP
MADHYA PRADESH,2010,Total,215,1790,1668,990,424,5087,161,2075,1105,392,183,3916,9003,MP
MADHYA PRADESH,2010,Total Salaried,0,207,220,110,40,577,2,33,26,14,10,85,662,MP
MADHYA PRADESH,2010,Total Self-employed,66,1011,1063,642,279,3061,53,407,219,98,44,821,3882,MP
MAHARASHTRA,2010,Others (Please Specify),3,867,1130,665,323,2988,8,142,86,49,27,312,3300,MH
MAHARASHTRA,2010,House Wife,0,0,0,0,0,0,0,1882,1098,405,254,3639,3639,MH
MAHARASHTRA,2010,Service (Government),0,35,78,59,1,173,0,8,1,1,0,10,183,MH
MAHARASHTRA,2010,Service (Private),0,559,739,376,40,1714,1,93,34,15,0,143,1857,MH
MAHARASHTRA,2010,Public Sector Undertaking,0,40,69,28,6,143,0,3,1,0,0,4,147,MH
MAHARASHTRA,2010,Student,46,427,8,1,0,482,82,492,0,0,0,574,1056,MH
MAHARASHTRA,2010,Unemployed,0,365,305,108,41,819,2,60,20,6,1,89,908,MH
MAHARASHTRA,2010,Self-employed (Business activity),0,143,172,100,24,439,0,3,3,0,0,6,445,MH
MAHARASHTRA,2010,Professional Activity,0,265,376,270,129,1040,0,42,22,15,4,83,1123,MH
MAHARASHTRA,2010,Farming/Agriculture Activity,0,784,1094,743,326,2947,2,79,68,33,12,194,3141,MH
MAHARASHTRA,2010,Retired Person,0,0,1,13,99,113,0,0,1,0,3,4,117,MH
MAHARASHTRA,2010,Total,49,3485,3972,2363,989,10858,95,2804,1334,524,301,5058,15916,MH
MAHARASHTRA,2010,Total Salaried,0,634,886,463,47,2030,1,104,36,16,0,157,2187,MH
MAHARASHTRA,2010,Total Self-employed,0,1984,2662,1699,749,7094,5,258,172,92,39,566,7660,MH
MANIPUR,2010,Others (Please Specify),0,1,3,1,0,5,0,1,0,0,0,1,6,MN
MANIPUR,2010,House Wife,0,0,0,0,0,0,0,6,1,1,0,8,8,MN
MANIPUR,2010,Service (Government),0,1,3,2,0,6,0,0,0,0,0,0,6,MN
MANIPUR,2010,Service (Private),0,0,0,0,0,0,0,0,0,0,0,0,0,MN
MANIPUR,2010,Public Sector Undertaking,0,0,0,0,0,0,0,0,0,0,0,0,0,MN
MANIPUR,2010,Student,0,1,0,0,0,1,0,0,0,0,0,0,1,MN
MANIPUR,2010,Unemployed,0,4,7,1,0,12,0,0,0,0,0,0,12,MN
MANIPUR,2010,Self-employed (Business activity),0,0,0,0,0,0,0,0,0,0,0,0,0,MN
MANIPUR,2010,Professional Activity,0,0,0,0,0,0,0,0,0,0,0,0,0,MN
MANIPUR,2010,Farming/Agriculture Activity,0,0,0,0,0,0,0,1,3,0,0,4,4,MN
MANIPUR,2010,Retired Person,0,0,0,0,0,0,0,0,0,0,0,0,0,MN
MANIPUR,2010,Total,0,7,13,4,0,24,0,8,4,1,0,13,37,MN
MANIPUR,2010,Total Salaried,0,1,3,2,0,6,0,0,0,0,0,0,6,MN
MANIPUR,2010,Total Self-employed,0,0,0,0,0,0,0,1,3,0,0,4,4,MN
MEGHALAYA,2010,Others (Please Specify),0,8,2,2,2,14,0,2,2,0,0,4,18,ML
MEGHALAYA,2010,House Wife,0,0,0,0,0,0,0,7,5,1,1,14,14,ML
MEGHALAYA,2010,Service (Government),0,2,4,2,0,8,0,0,0,0,0,0,8,ML
MEGHALAYA,2010,Service (Private),0,6,1,4,0,11,0,0,0,0,0,0,11,ML
MEGHALAYA,2010,Public Sector Undertaking,0,1,0,0,0,1,0,0,0,0,0,0,1,ML
MEGHALAYA,2010,Student,2,10,2,0,0,14,1,5,1,0,0,7,21,ML
MEGHALAYA,2010,Unemployed,0,5,8,2,0,15,0,1,1,0,0,2,17,ML
MEGHALAYA,2010,Self-employed (Business activity),0,0,0,0,0,0,0,0,0,0,0,0,0,ML
MEGHALAYA,2010,Professional Activity,0,0,1,0,0,1,0,0,0,0,0,0,1,ML
MEGHALAYA,2010,Farming/Agriculture Activity,0,5,5,3,2,15,0,0,0,1,0,1,16,ML
MEGHALAYA,2010,Retired Person,0,0,0,0,1,1,0,0,0,0,0,0,1,ML
MEGHALAYA,2010,Total,2,37,23,13,5,80,1,15,9,2,1,28,108,ML
MEGHALAYA,2010,Total Salaried,0,9,5,6,0,20,0,0,0,0,0,0,20,ML
MEGHALAYA,2010,Total Self-employed,0,7,6,4,4,21,0,1,1,1,0,3,24,ML
MIZORAM,2010,Others (Please Specify),0,6,10,0,0,16,0,2,0,0,0,2,18,MZ
MIZORAM,2010,House Wife,0,0,0,0,0,0,0,0,0,0,0,0,0,MZ
MIZORAM,2010,Service (Government),0,10,10,2,1,23,0,4,0,0,0,4,27,MZ
MIZORAM,2010,Service (Private),2,0,0,0,0,2,0,0,1,0,0,1,3,MZ
MIZORAM,2010,Public Sector Undertaking,0,0,0,0,0,0,0,0,0,0,0,0,0,MZ
MIZORAM,2010,Student,2,0,0,0,0,2,0,0,0,0,0,0,2,MZ
MIZORAM,2010,Unemployed,0,10,5,3,1,19,0,2,0,0,0,2,21,MZ
MIZORAM,2010,Self-employed (Business activity),0,0,0,0,0,0,0,0,0,0,0,0,0,MZ
MIZORAM,2010,Professional Activity,0,0,0,0,0,0,0,0,0,0,0,0,0,MZ
MIZORAM,2010,Farming/Agriculture Activity,0,4,0,1,0,5,0,0,0,0,0,0,5,MZ
MIZORAM,2010,Retired Person,0,0,0,0,0,0,0,0,0,0,0,0,0,MZ
MIZORAM,2010,Total,4,30,25,6,2,67,0,8,1,0,0,9,76,MZ
MIZORAM,2010,Total Salaried,2,10,10,2,1,25,0,4,1,0,0,5,30,MZ
MIZORAM,2010,Total Self-employed,0,4,0,1,0,5,0,0,0,0,0,0,5,MZ
NAGALAND,2010,Others (Please Specify),0,0,0,0,0,0,0,0,0,0,0,0,0,NG
NAGALAND,2010,House Wife,0,0,0,0,0,0,0,1,0,0,0,1,1,NG
NAGALAND,2010,Service (Government),0,1,0,1,0,2,0,0,0,0,0,0,2,NG
NAGALAND,2010,Service (Private),0,0,0,0,0,0,0,0,0,0,0,0,0,NG
NAGALAND,2010,Public Sector Undertaking,0,0,0,0,0,0,0,0,0,0,0,0,0,NG
NAGALAND,2010,Student,0,0,2,0,0,2,0,0,0,0,0,0,2,NG
NAGALAND,2010,Unemployed,0,2,2,0,0,4,0,0,0,0,0,0,4,NG
NAGALAND,2010,Self-employed (Business activity),0,0,0,0,0,0,0,0,0,0,0,0,0,NG
NAGALAND,2010,Professional Activity,0,1,2,0,0,3,0,0,0,0,0,0,3,NG
NAGALAND,2010,Farming/Agriculture Activity,0,0,0,0,0,0,0,0,0,0,0,0,0,NG
NAGALAND,2010,Retired Person,0,0,0,0,0,0,0,0,0,0,0,0,0,NG
NAGALAND,2010,Total,0,4,6,1,0,11,0,1,0,0,0,1,12,NG
NAGALAND,2010,Total Salaried,0,1,0,1,0,2,0,0,0,0,0,0,2,NG
NAGALAND,2010,Total Self-employed,0,1,2,0,0,3,0,0,0,0,0,0,3,NG
ODISHA,2010,Others (Please Specify),58,300,348,289,91,1086,47,290,224,135,31,727,1813,OD
ODISHA,2010,House Wife,0,0,0,0,0,0,1,362,232,111,24,730,730,OD
ODISHA,2010,Service (Government),0,2,7,2,0,11,0,2,1,1,0,4,15,OD
ODISHA,2010,Service (Private),0,74,114,70,11,269,0,30,25,4,4,63,332,OD
ODISHA,2010,Public Sector Undertaking,0,57,39,14,0,110,0,13,16,6,0,35,145,OD
ODISHA,2010,Student,30,138,5,0,0,173,22,104,2,0,0,128,301,OD
ODISHA,2010,Unemployed,11,142,103,36,2,294,7,47,25,7,4,90,384,OD
ODISHA,2010,Self-employed (Business activity),0,52,115,70,7,244,0,3,14,2,0,19,263,OD
ODISHA,2010,Professional Activity,0,15,34,15,10,74,0,2,3,2,2,9,83,OD
ODISHA,2010,Farming/Agriculture Activity,0,17,77,36,15,145,0,0,12,5,0,17,162,OD
ODISHA,2010,Retired Person,0,0,0,1,23,24,0,0,0,1,2,3,27,OD
ODISHA,2010,Total,99,797,842,533,159,2430,77,853,554,274,67,1825,4255,OD
ODISHA,2010,Total Salaried,0,133,160,86,11,390,0,45,42,11,4,102,492,OD
ODISHA,2010,Total Self-employed,41,295,470,333,86,1225,39,191,183,108,26,547,1772,OD
PUDUCHERRY,2010,Others (Please Specify),0,1,5,2,0,8,1,0,0,0,0,1,9,PY
PUDUCHERRY,2010,House Wife,0,0,0,0,0,0,0,44,30,10,11,95,95,PY
PUDUCHERRY,2010,Service (Government),0,1,4,2,1,8,0,2,1,0,0,3,11,PY
PUDUCHERRY,2010,Service (Private),0,10,9,2,0,21,0,12,5,0,0,17,38,PY
PUDUCHERRY,2010,Public Sector Undertaking,0,0,2,2,0,4,0,0,2,0,0,2,6,PY
PUDUCHERRY,2010,Student,2,4,0,0,0,6,2,10,0,0,0,12,18,PY
PUDUCHERRY,2010,Unemployed,0,17,14,13,16,60,0,29,4,0,7,40,100,PY
PUDUCHERRY,2010,Self-employed (Business activity),0,3,8,3,0,14,0,0,0,0,0,0,14,PY
PUDUCHERRY,2010,Professional Activity,0,34,98,68,5,205,0,2,0,2,1,5,210,PY
PUDUCHERRY,2010,Farming/Agriculture Activity,0,0,1,3,0,4,0,0,0,0,0,0,4,PY
PUDUCHERRY,2010,Retired Person,0,0,0,0,3,3,0,0,0,0,0,0,3,PY
PUDUCHERRY,2010,Total,2,70,141,95,25,333,3,99,42,12,19,175,508,PY
PUDUCHERRY,2010,Total Salaried,0,11,15,6,1,33,0,14,8,0,0,22,55,PY
PUDUCHERRY,2010,Total Self-employed,0,38,112,76,5,231,1,2,0,2,1,6,237,PY
PUNJAB,2010,Others (Please Specify),1,121,121,92,41,376,1,16,11,5,3,36,412,PN
PUNJAB,2010,House Wife,0,0,0,0,0,0,1,60,48,16,5,130,130,PN
PUNJAB,2010,Service (Government),0,5,13,3,0,21,0,2,0,0,0,2,23,PN
PUNJAB,2010,Service (Private),2,27,44,7,2,82,0,0,1,0,0,1,83,PN
PUNJAB,2010,Public Sector Undertaking,0,0,0,0,0,0,0,0,0,0,0,0,0,PN
PUNJAB,2010,Student,4,21,6,0,0,31,1,23,0,0,0,24,55,PN
PUNJAB,2010,Unemployed,3,25,23,5,3,59,0,3,1,0,4,8,67,PN
PUNJAB,2010,Self-employed (Business activity),0,20,16,4,1,41,0,0,0,0,0,0,41,PN
PUNJAB,2010,Professional Activity,0,13,5,3,0,21,0,0,0,0,0,0,21,PN
PUNJAB,2010,Farming/Agriculture Activity,0,27,31,12,10,80,0,0,0,0,0,0,80,PN
PUNJAB,2010,Retired Person,0,0,0,1,7,8,0,0,0,0,0,0,8,PN
PUNJAB,2010,Total,10,259,259,127,64,719,3,104,61,21,12,201,920,PN
PUNJAB,2010,Total Salaried,2,32,57,10,2,103,0,2,1,0,0,3,106,PN
PUNJAB,2010,Total Self-employed,0,137,129,78,37,381,1,5,3,2,3,14,395,PN
RAJASTHAN,2010,Others (Please Specify),69,552,755,490,87,1953,36,142,83,39,11,311,2264,RJ
RAJASTHAN,2010,House Wife,0,0,0,0,0,0,19,426,403,161,25,1034,1034,RJ
RAJASTHAN,2010,Service (Government),0,5,20,11,0,36,0,0,6,0,0,6,42,RJ
RAJASTHAN,2010,Service (Private),0,135,149,97,22,403,0,16,7,5,0,28,431,RJ
RAJASTHAN,2010,Public Sector Undertaking,0,8,10,13,3,34,0,3,3,0,0,6,40,RJ
RAJASTHAN,2010,Student,19,118,7,0,0,144,12,75,1,1,0,89,233,RJ
RAJASTHAN,2010,Unemployed,0,78,66,24,4,172,0,9,11,7,0,27,199,RJ
RAJASTHAN,2010,Self-employed (Business activity),0,55,89,26,6,176,0,2,2,1,0,5,181,RJ
RAJASTHAN,2010,Professional Activity,0,14,39,2,6,61,0,2,1,1,0,4,65,RJ
RAJASTHAN,2010,Farming/Agriculture Activity,2,114,146,66,23,351,0,20,13,6,0,39,390,RJ
RAJASTHAN,2010,Retired Person,0,14,7,9,5,35,0,6,0,0,0,6,41,RJ
RAJASTHAN,2010,Total,90,1093,1288,738,156,3365,67,701,530,221,36,1555,4920,RJ
RAJASTHAN,2010,Total Salaried,0,148,179,121,25,473,0,19,16,5,0,40,513,RJ
RAJASTHAN,2010,Total Self-employed,4,409,660,355,76,1504,5,80,36,19,3,143,1647,RJ
SIKKIM,2010,Others (Please Specify),0,7,0,11,2,20,0,1,1,7,0,9,29,SK
SIKKIM,2010,House Wife,0,0,0,0,0,0,0,2,1,1,1,5,5,SK
SIKKIM,2010,Service (Government),0,17,11,1,0,29,0,1,5,0,0,6,35,SK
SIKKIM,2010,Service (Private),9,23,17,1,2,52,0,1,2,0,0,3,55,SK
SIKKIM,2010,Public Sector Undertaking,0,11,7,3,0,21,0,5,5,0,0,10,31,SK
SIKKIM,2010,Student,0,2,0,0,0,2,0,1,0,0,0,1,3,SK
SIKKIM,2010,Unemployed,11,13,12,7,2,45,0,2,5,0,0,7,52,SK
SIKKIM,2010,Self-employed (Business activity),0,11,10,0,2,23,0,0,0,1,0,1,24,SK
SIKKIM,2010,Professional Activity,0,9,9,0,3,21,0,0,0,1,0,1,22,SK
SIKKIM,2010,Farming/Agriculture Activity,1,5,5,7,1,19,0,0,0,0,0,0,19,SK
SIKKIM,2010,Retired Person,0,0,0,0,3,3,0,0,0,0,2,2,5,SK
SIKKIM,2010,Total,21,98,71,30,15,235,0,13,19,10,3,45,280,SK
SIKKIM,2010,Total Salaried,9,51,35,5,2,102,0,7,12,0,0,19,121,SK
SIKKIM,2010,Total Self-employed,1,32,24,7,6,70,0,0,1,2,0,3,73,SK
TAMIL NADU,2010,Others (Please Specify),83,1435,1627,1235,843,5223,103,708,405,271,203,1690,6913,TN
TAMIL NADU,2010,House Wife,0,0,0,0,0,0,3,935,984,520,225,2667,2667,TN
TAMIL NADU,2010,Service (Government),0,21,40,61,0,122,0,18,23,16,1,58,180,TN
TAMIL NADU,2010,Service (Private),1,383,609,384,53,1430,0,152,84,67,2,305,1735,TN
TAMIL NADU,2010,Public Sector Undertaking,0,53,122,78,11,264,0,28,37,12,0,77,341,TN
TAMIL NADU,2010,Student,99,254,6,0,0,359,65,208,5,0,0,278,637,TN
TAMIL NADU,2010,Unemployed,3,418,577,360,169,1527,3,289,136,90,27,545,2072,TN
TAMIL NADU,2010,Self-employed (Business activity),0,212,314,273,62,861,6,85,77,32,19,219,1080,TN
TAMIL NADU,2010,Professional Activity,0,53,86,50,23,212,5,16,18,10,2,51,263,TN
TAMIL NADU,2010,Farming/Agriculture Activity,13,137,131,103,58,442,0,65,25,6,3,99,541,TN
TAMIL NADU,2010,Retired Person,0,0,0,35,77,112,0,0,0,5,15,20,132,TN
TAMIL NADU,2010,Total,199,2966,3512,2579,1296,10552,185,2504,1794,1029,497,6009,16561,TN
TAMIL NADU,2010,Total Salaried,1,457,771,523,64,1816,0,198,144,95,3,440,2256,TN
TAMIL NADU,2010,Total Self-employed,73,1097,1121,802,372,3465,30,462,382,161,101,1136,4601,TN
TRIPURA,2010,Others (Please Specify),1,19,50,34,18,122,3,16,6,2,0,27,149,TR
TRIPURA,2010,House Wife,0,0,0,0,0,0,1,72,64,34,23,194,194,TR
TRIPURA,2010,Service (Government),0,2,8,8,0,18,0,0,0,1,0,1,19,TR
TRIPURA,2010,Service (Private),0,14,5,6,5,30,0,0,0,0,0,0,30,TR
TRIPURA,2010,Public Sector Undertaking,0,0,0,0,0,0,0,0,0,0,0,0,0,TR
TRIPURA,2010,Student,15,57,2,0,0,74,14,16,2,0,0,32,106,TR
TRIPURA,2010,Unemployed,0,4,3,14,14,35,0,0,0,0,6,6,41,TR
TRIPURA,2010,Self-employed (Business activity),0,15,42,6,12,75,0,3,4,5,0,12,87,TR
TRIPURA,2010,Professional Activity,0,5,17,5,3,30,0,0,0,0,0,0,30,TR
TRIPURA,2010,Farming/Agriculture Activity,0,11,15,17,3,46,0,1,4,7,0,12,58,TR
TRIPURA,2010,Retired Person,0,0,0,1,10,11,0,0,0,0,0,0,11,TR
TRIPURA,2010,Total,16,127,142,91,65,441,18,108,80,49,29,284,725,TR
TRIPURA,2010,Total Salaried,0,16,13,14,5,48,0,0,0,1,0,1,49,TR
TRIPURA,2010,Total Self-employed,1,50,124,62,36,273,3,20,14,14,0,51,324,TR
UTTAR PRADESH,2010,Others (Please Specify),26,145,156,86,49,462,13,232,67,22,7,341,803,UP
UTTAR PRADESH,2010,House Wife,0,0,0,0,0,0,8,480,350,105,62,1005,1005,UP
UTTAR PRADESH,2010,Service (Government),0,14,16,7,1,38,0,60,9,6,0,75,113,UP
UTTAR PRADESH,2010,Service (Private),0,90,51,42,5,188,4,37,20,8,1,70,258,UP
UTTAR PRADESH,2010,Public Sector Undertaking,0,5,7,4,0,16,0,3,2,1,0,6,22,UP
UTTAR PRADESH,2010,Student,13,131,10,2,0,156,29,132,0,0,0,161,317,UP
UTTAR PRADESH,2010,Unemployed,5,95,88,32,12,232,0,23,24,9,0,56,288,UP
UTTAR PRADESH,2010,Self-employed (Business activity),0,50,60,45,29,184,0,5,2,0,0,7,191,UP
UTTAR PRADESH,2010,Professional Activity,0,32,21,9,5,67,0,0,0,0,0,0,67,UP
UTTAR PRADESH,2010,Farming/Agriculture Activity,2,110,171,116,33,432,4,54,31,19,8,116,548,UP
UTTAR PRADESH,2010,Retired Person,0,0,0,4,8,12,0,1,0,2,1,4,16,UP
UTTAR PRADESH,2010,Total,46,672,580,347,142,1787,58,1027,505,172,79,1841,3628,UP
UTTAR PRADESH,2010,Total Salaried,0,109,74,53,6,242,4,100,31,15,1,151,393,UP
UTTAR PRADESH,2010,Total Self-employed,8,301,375,216,97,997,13,183,92,41,15,344,1341,UP
UTTARAKHAND,2010,Others (Please Specify),0,17,20,7,7,51,3,11,6,3,0,23,74,UK
UTTARAKHAND,2010,House Wife,0,0,0,0,0,0,0,28,18,6,2,54,54,UK
UTTARAKHAND,2010,Service (Government),0,4,6,1,0,11,0,1,2,0,0,3,14,UK
UTTARAKHAND,2010,Service (Private),0,7,10,4,0,21,0,3,0,0,0,3,24,UK
UTTARAKHAND,2010,Public Sector Undertaking,0,0,0,0,0,0,0,1,0,0,0,1,1,UK
UTTARAKHAND,2010,Student,2,8,0,0,0,10,4,20,0,0,0,24,34,UK
UTTARAKHAND,2010,Unemployed,0,14,0,5,0,19,0,1,2,0,0,3,22,UK
UTTARAKHAND,2010,Self-employed (Business activity),2,4,6,2,1,15,0,0,0,0,0,0,15,UK
UTTARAKHAND,2010,Professional Activity,0,0,1,0,0,1,0,0,0,0,0,0,1,UK
UTTARAKHAND,2010,Farming/Agriculture Activity,0,8,14,7,4,33,0,4,2,0,0,6,39,UK
UTTARAKHAND,2010,Retired Person,0,0,0,3,0,3,0,0,0,0,0,0,3,UK
UTTARAKHAND,2010,Total,4,62,57,29,12,164,7,69,30,9,2,117,281,UK
UTTARAKHAND,2010,Total Salaried,0,11,16,5,0,32,0,5,2,0,0,7,39,UK
UTTARAKHAND,2010,Total Self-employed,2,20,30,14,9,75,0,8,5,1,0,14,89,UK
WEST BENGAL,2010,Others (Please Specify),158,1216,1537,1213,431,4555,115,735,854,632,161,2497,7052,WB
WEST BENGAL,2010,House Wife,0,0,0,0,0,0,0,1271,1123,459,75,2928,2928,WB
WEST BENGAL,2010,Service (Government),0,17,84,39,1,141,0,4,7,8,0,19,160,WB
WEST BENGAL,2010,Service (Private),0,143,243,253,7,646,0,64,69,19,5,157,803,WB
WEST BENGAL,2010,Public Sector Undertaking,0,83,264,195,2,544,0,57,44,12,11,124,668,WB
WEST BENGAL,2010,Student,108,398,35,3,0,544,97,280,23,5,0,405,949,WB
WEST BENGAL,2010,Unemployed,0,304,382,75,3,764,0,114,127,23,1,265,1029,WB
WEST BENGAL,2010,Self-employed (Business activity),0,241,329,260,21,851,0,7,24,6,0,37,888,WB
WEST BENGAL,2010,Professional Activity,0,56,232,102,11,401,0,31,53,10,6,100,501,WB
WEST BENGAL,2010,Farming/Agriculture Activity,2,218,389,164,27,800,0,63,53,57,20,193,993,WB
WEST BENGAL,2010,Retired Person,0,0,0,0,55,55,0,0,0,0,11,11,66,WB
WEST BENGAL,2010,Total,268,2676,3495,2304,558,9301,212,2626,2377,1231,290,6736,16037,WB
WEST BENGAL,2010,Total Salaried,0,243,591,487,10,1331,0,125,120,39,16,300,1631,WB
WEST BENGAL,2010,Total Self-employed,72,1149,1882,1153,273,4529,33,517,638,384,100,1672,6201,WB
A & N ISLANDS,2011,Others (Please Specify),0,2,4,2,3,11,0,0,1,0,0,1,12,AN
A & N ISLANDS,2011,House Wife,0,0,0,0,0,0,0,3,4,2,1,10,10,AN
A & N ISLANDS,2011,Service (Government),0,7,6,4,1,18,0,2,1,1,0,4,22,AN
A & N ISLANDS,2011,Service (Private),0,7,17,8,1,33,0,4,4,1,1,10,43,AN
A & N ISLANDS,2011,Public Sector Undertaking,0,0,0,0,0,0,0,0,0,0,0,0,0,AN
A & N ISLANDS,2011,Student,1,9,0,0,0,10,4,8,0,1,0,13,23,AN
A & N ISLANDS,2011,Unemployed,0,3,5,2,0,10,0,0,0,1,0,1,11,AN
A & N ISLANDS,2011,Self-employed (Business activity),0,0,3,4,0,7,0,2,0,0,0,2,9,AN
A & N ISLANDS,2011,Professional Activity,0,0,0,0,0,0,0,0,0,0,0,0,0,AN
A & N ISLANDS,2011,Farming/Agriculture Activity,0,0,0,0,0,0,0,0,0,0,0,0,0,AN
A & N ISLANDS,2011,Retired Person,0,0,0,0,5,5,0,0,1,0,0,1,6,AN
A & N ISLANDS,2011,Total,1,28,35,20,10,94,4,19,11,6,2,42,136,AN
A & N ISLANDS,2011,Total Salaried,0,14,23,12,2,51,0,6,5,2,1,14,65,AN
A & N ISLANDS,2011,Total Self-employed,0,0,6,4,0,10,0,2,1,0,0,3,13,AN
ANDHRA PRADESH,2011,Others (Please Specify),62,1136,1525,1191,462,4376,80,587,377,177,148,1369,5745,AP
ANDHRA PRADESH,2011,House Wife,0,0,0,0,0,0,1,1007,832,332,116,2288,2288,AP
ANDHRA PRADESH,2011,Service (Government),0,12,41,36,0,89,0,10,8,2,0,20,109,AP
ANDHRA PRADESH,2011,Service (Private),0,311,543,419,114,1387,0,91,104,36,12,243,1630,AP
ANDHRA PRADESH,2011,Public Sector Undertaking,0,99,83,81,25,288,0,22,51,3,3,79,367,AP
ANDHRA PRADESH,2011,Student,45,235,7,0,0,287,59,216,1,0,0,276,563,AP
ANDHRA PRADESH,2011,Unemployed,0,181,248,98,8,535,0,59,30,14,4,107,642,AP
ANDHRA PRADESH,2011,Self-employed (Business activity),0,275,311,263,112,961,0,69,39,22,3,133,1094,AP
ANDHRA PRADESH,2011,Professional Activity,0,116,123,76,25,340,0,21,11,9,11,52,392,AP
ANDHRA PRADESH,2011,Farming/Agriculture Activity,5,463,670,541,143,1822,3,202,102,67,10,384,2206,AP
ANDHRA PRADESH,2011,Retired Person,0,0,0,5,30,35,0,0,0,1,5,6,41,AP
ANDHRA PRADESH,2011,Total,112,2828,3551,2710,919,10120,143,2284,1555,663,312,4957,15077,AP
ANDHRA PRADESH,2011,Total Salaried,0,422,667,536,139,1764,0,123,163,41,15,342,2106,AP
ANDHRA PRADESH,2011,Total Self-employed,39,1561,2007,1439,560,5606,50,634,373,203,122,1382,6988,AP
ARUNACHAL PRADESH,2011,Others (Please Specify),1,4,11,4,0,20,3,1,1,0,0,5,25,AR
ARUNACHAL PRADESH,2011,House Wife,0,0,0,0,0,0,0,11,8,1,1,21,21,AR
ARUNACHAL PRADESH,2011,Service (Government),0,2,9,5,0,16,0,0,0,0,0,0,16,AR
ARUNACHAL PRADESH,2011,Service (Private),0,9,4,1,1,15,0,0,0,0,0,0,15,AR
ARUNACHAL PRADESH,2011,Public Sector Undertaking,0,2,3,4,0,9,0,0,0,0,0,0,9,AR
ARUNACHAL PRADESH,2011,Student,3,7,0,0,0,10,1,4,0,0,0,5,15,AR
ARUNACHAL PRADESH,2011,Unemployed,0,5,2,0,0,7,1,2,0,0,0,3,10,AR
ARUNACHAL PRADESH,2011,Self-employed (Business activity),0,5,1,3,0,9,0,0,0,0,0,0,9,AR
ARUNACHAL PRADESH,2011,Professional Activity,0,0,0,0,0,0,0,0,0,0,0,0,0,AR
ARUNACHAL PRADESH,2011,Farming/Agriculture Activity,0,4,4,3,1,12,0,1,0,0,0,1,13,AR
ARUNACHAL PRADESH,2011,Retired Person,0,0,0,0,1,1,0,0,0,0,0,0,1,AR
ARUNACHAL PRADESH,2011,Total,4,38,34,20,3,99,5,19,9,1,1,35,134,AR
ARUNACHAL PRADESH,2011,Total Salaried,0,13,16,10,1,40,0,0,0,0,0,0,40,AR
ARUNACHAL PRADESH,2011,Total Self-employed,1,13,9,10,1,34,3,2,1,0,0,6,40,AR
ASSAM,2011,Others (Please Specify),12,228,294,183,28,745,6,121,76,28,3,234,979,AS
ASSAM,2011,House Wife,0,0,0,0,0,0,0,175,214,92,9,490,490,AS
ASSAM,2011,Service (Government),0,5,13,9,0,27,0,0,1,0,0,1,28,AS
ASSAM,2011,Service (Private),0,26,44,16,0,86,0,0,8,4,0,12,98,AS
ASSAM,2011,Public Sector Undertaking,0,17,52,22,0,91,1,4,2,1,0,8,99,AS
ASSAM,2011,Student,8,152,0,0,0,160,3,81,8,0,0,92,252,AS
ASSAM,2011,Unemployed,0,7,15,21,5,48,0,6,5,0,0,11,59,AS
ASSAM,2011,Self-employed (Business activity),0,107,110,63,1,281,0,17,22,1,0,40,321,AS
ASSAM,2011,Professional Activity,0,28,33,24,0,85,0,0,0,0,0,0,85,AS
ASSAM,2011,Farming/Agriculture Activity,0,97,125,70,8,300,0,6,5,0,1,12,312,AS
ASSAM,2011,Retired Person,0,0,0,0,3,3,0,0,0,0,0,0,3,AS
ASSAM,2011,Total,20,667,686,408,45,1826,10,410,341,126,13,900,2726,AS
ASSAM,2011,Total Salaried,0,48,109,47,0,204,1,4,11,5,0,21,225,AS
ASSAM,2011,Total Self-employed,7,386,484,291,29,1197,4,92,62,14,4,176,1373,AS
BIHAR,2011,Others (Please Specify),11,89,95,44,18,257,36,35,38,9,11,129,386,BR
BIHAR,2011,House Wife,0,0,0,0,0,0,0,71,55,9,3,138,138,BR
BIHAR,2011,Service (Government),0,3,5,1,0,9,0,10,9,1,0,20,29,BR
BIHAR,2011,Service (Private),0,2,3,3,1,9,0,0,0,0,0,0,9,BR
BIHAR,2011,Public Sector Undertaking,0,1,1,1,0,3,0,0,0,0,0,0,3,BR
BIHAR,2011,Student,5,27,4,0,0,36,5,28,2,0,0,35,71,BR
BIHAR,2011,Unemployed,0,14,22,12,1,49,0,5,2,0,0,7,56,BR
BIHAR,2011,Self-employed (Business activity),0,1,4,4,0,9,0,0,0,0,0,0,9,BR
BIHAR,2011,Professional Activity,0,2,2,3,0,7,0,0,0,0,0,0,7,BR
BIHAR,2011,Farming/Agriculture Activity,0,11,27,19,6,63,0,0,20,0,0,20,83,BR
BIHAR,2011,Retired Person,0,0,0,1,3,4,0,0,0,0,0,0,4,BR
BIHAR,2011,Total,16,150,163,88,29,446,41,149,126,19,14,349,795,BR
BIHAR,2011,Total Salaried,0,6,9,5,1,21,0,10,9,1,0,20,41,BR
BIHAR,2011,Total Self-employed,3,35,46,39,10,133,8,9,30,1,0,48,181,BR
CHANDIGARH,2011,Others (Please Specify),0,10,6,3,1,20,0,4,1,0,0,5,25,CH
CHANDIGARH,2011,House Wife,0,0,0,0,0,0,0,13,13,2,0,28,28,CH
CHANDIGARH,2011,Service (Government),0,0,1,2,0,3,0,0,0,0,0,0,3,CH
CHANDIGARH,2011,Service (Private),0,2,8,7,0,17,0,2,0,1,0,3,20,CH
CHANDIGARH,2011,Public Sector Undertaking,0,0,0,0,0,0,0,0,0,0,0,0,0,CH
CHANDIGARH,2011,Student,0,4,0,0,0,4,0,10,0,0,0,10,14,CH
CHANDIGARH,2011,Unemployed,0,8,1,1,0,10,0,2,0,0,0,2,12,CH
CHANDIGARH,2011,Self-employed (Business activity),0,0,3,0,0,3,0,0,0,0,0,0,3,CH
CHANDIGARH,2011,Professional Activity,0,0,0,0,0,0,0,0,0,0,0,0,0,CH
CHANDIGARH,2011,Farming/Agriculture Activity,0,0,0,0,0,0,0,0,0,0,0,0,0,CH
CHANDIGARH,2011,Retired Person,0,0,0,0,0,0,0,0,0,0,0,0,0,CH
CHANDIGARH,2011,Total,0,24,19,13,1,57,0,31,14,3,0,48,105,CH
CHANDIGARH,2011,Total Salaried,0,2,9,9,0,20,0,2,0,1,0,3,23,CH
CHANDIGARH,2011,Total Self-employed,0,10,9,3,1,23,0,1,0,0,0,1,24,CH
CHHATTISGARH,2011,Others (Please Specify),57,794,950,751,363,2915,49,372,328,232,104,1085,4000,CG
CHHATTISGARH,2011,House Wife,0,0,0,0,0,0,3,384,239,121,28,775,775,CG
CHHATTISGARH,2011,Service (Government),0,19,21,5,1,46,1,4,3,0,0,8,54,CG
CHHATTISGARH,2011,Service (Private),2,135,120,59,5,321,2,42,31,8,6,89,410,CG
CHHATTISGARH,2011,Public Sector Undertaking,0,12,20,29,0,61,0,3,6,2,0,11,72,CG
CHHATTISGARH,2011,Student,40,152,9,0,0,201,31,130,0,0,0,161,362,CG
CHHATTISGARH,2011,Unemployed,3,182,246,146,15,592,0,18,11,3,2,34,626,CG
CHHATTISGARH,2011,Self-employed (Business activity),0,65,81,55,17,218,0,1,4,4,1,10,228,CG
CHHATTISGARH,2011,Professional Activity,0,64,51,32,7,154,0,34,16,6,0,56,210,CG
CHHATTISGARH,2011,Farming/Agriculture Activity,0,0,0,0,0,0,0,0,0,0,0,0,0,CG
CHHATTISGARH,2011,Retired Person,0,5,3,4,7,19,0,0,0,0,0,0,19,CG
CHHATTISGARH,2011,Total,102,1428,1501,1081,415,4527,86,988,638,376,141,2229,6756,CG
CHHATTISGARH,2011,Total Salaried,2,166,161,93,6,428,3,49,40,10,6,108,536,CG
CHHATTISGARH,2011,Total Self-employed,16,622,806,617,266,2327,13,255,234,163,58,723,3050,CG
D & N HAVELI,2011,Others (Please Specify),0,1,2,0,0,3,0,0,0,1,1,2,5,DN
D & N HAVELI,2011,House Wife,0,0,0,0,0,0,0,5,5,2,0,12,12,DN
D & N HAVELI,2011,Service (Government),0,0,0,0,0,0,0,0,0,0,0,0,0,DN
D & N HAVELI,2011,Service (Private),0,15,3,2,0,20,0,5,0,0,0,5,25,DN
D & N HAVELI,2011,Public Sector Undertaking,0,0,0,0,0,0,0,0,0,0,0,0,0,DN
D & N HAVELI,2011,Student,0,3,0,0,0,3,0,3,0,0,0,3,6,DN
D & N HAVELI,2011,Unemployed,0,0,0,0,0,0,0,0,0,0,0,0,0,DN
D & N HAVELI,2011,Self-employed (Business activity),0,0,0,2,0,2,0,0,0,0,0,0,2,DN
D & N HAVELI,2011,Professional Activity,0,0,0,0,0,0,0,0,0,0,0,0,0,DN
D & N HAVELI,2011,Farming/Agriculture Activity,0,4,3,5,1,13,0,0,0,0,0,0,13,DN
D & N HAVELI,2011,Retired Person,0,0,0,0,0,0,0,0,0,0,0,0,0,DN
D & N HAVELI,2011,Total,0,23,8,9,1,41,0,13,5,3,1,22,63,DN
D & N HAVELI,2011,Total Salaried,0,15,3,2,0,20,0,5,0,0,0,5,25,DN
D & N HAVELI,2011,Total Self-employed,0,5,5,7,1,18,0,0,0,1,1,2,20,DN
DAMAN & DIU,2011,Others (Please Specify),0,1,2,1,0,4,0,1,0,0,0,1,5,DD
DAMAN & DIU,2011,House Wife,0,0,0,0,0,0,0,5,1,1,0,7,7,DD
DAMAN & DIU,2011,Service (Government),0,0,0,0,0,0,0,0,0,0,0,0,0,DD
DAMAN & DIU,2011,Service (Private),0,6,4,3,0,13,0,3,0,0,0,3,16,DD
DAMAN & DIU,2011,Public Sector Undertaking,0,0,0,0,0,0,0,0,0,0,0,0,0,DD
DAMAN & DIU,2011,Student,1,0,0,0,0,1,0,4,0,0,0,4,5,DD
DAMAN & DIU,2011,Unemployed,0,0,0,0,0,0,0,0,0,0,0,0,0,DD
DAMAN & DIU,2011,Self-employed (Business activity),0,0,0,0,0,0,0,0,0,0,0,0,0,DD
DAMAN & DIU,2011,Professional Activity,0,0,0,0,0,0,0,0,0,0,0,0,0,DD
DAMAN & DIU,2011,Farming/Agriculture Activity,0,0,0,0,0,0,0,0,0,0,0,0,0,DD
DAMAN & DIU,2011,Retired Person,0,0,0,0,0,0,0,0,0,0,0,0,0,DD
DAMAN & DIU,2011,Total,1,7,6,4,0,18,0,13,1,1,0,15,33,DD
DAMAN & DIU,2011,Total Salaried,0,6,4,3,0,13,0,3,0,0,0,3,16,DD
DAMAN & DIU,2011,Total Self-employed,0,0,0,1,0,1,0,0,0,0,0,0,1,DD
DELHI (UT),2011,Others (Please Specify),5,165,98,56,17,341,7,44,18,11,1,81,422,DL
DELHI (UT),2011,House Wife,0,0,0,0,0,0,0,158,101,20,11,290,290,DL
DELHI (UT),2011,Service (Government),0,12,10,5,0,27,0,4,1,1,0,6,33,DL
DELHI (UT),2011,Service (Private),0,97,100,28,2,227,0,21,5,2,0,28,255,DL
DELHI (UT),2011,Public Sector Undertaking,0,20,6,3,0,29,0,1,0,0,0,1,30,DL
DELHI (UT),2011,Student,12,102,0,0,0,114,11,75,0,0,0,86,200,DL
DELHI (UT),2011,Unemployed,1,210,130,25,4,370,1,40,10,3,1,55,425,DL
DELHI (UT),2011,Self-employed (Business activity),0,9,10,7,0,26,0,0,0,1,0,1,27,DL
DELHI (UT),2011,Professional Activity,0,5,7,1,0,13,0,0,0,0,0,0,13,DL
DELHI (UT),2011,Farming/Agriculture Activity,0,2,6,2,0,10,0,0,0,0,0,0,10,DL
DELHI (UT),2011,Retired Person,0,0,0,0,11,11,0,0,0,0,0,0,11,DL
DELHI (UT),2011,Total,18,622,367,127,34,1168,19,343,135,38,13,548,1716,DL
DELHI (UT),2011,Total Salaried,0,129,116,36,2,283,0,26,6,3,0,35,318,DL
DELHI (UT),2011,Total Self-employed,1,86,70,29,7,193,1,13,7,11,0,32,225,DL
GOA,2011,Others (Please Specify),1,14,43,16,9,83,0,3,0,1,0,4,87,GA
GOA,2011,House Wife,0,0,0,0,0,0,0,18,22,7,9,56,56,GA
GOA,2011,Service (Government),0,0,0,0,0,0,0,0,0,0,0,0,0,GA
GOA,2011,Service (Private),0,19,25,9,0,53,0,7,1,0,0,8,61,GA
GOA,2011,Public Sector Undertaking,0,0,0,0,0,0,0,0,0,0,0,0,0,GA
GOA,2011,Student,3,4,0,0,0,7,2,17,1,0,0,20,27,GA
GOA,2011,Unemployed,1,13,12,13,4,43,1,5,2,0,0,8,51,GA
GOA,2011,Self-employed (Business activity),0,0,0,0,0,0,0,0,0,0,0,0,0,GA
GOA,2011,Professional Activity,0,2,1,1,0,4,0,1,0,0,0,1,5,GA
GOA,2011,Farming/Agriculture Activity,0,0,0,0,1,1,0,0,0,0,0,0,1,GA
GOA,2011,Retired Person,0,0,0,0,4,4,0,0,0,1,0,1,5,GA
GOA,2011,Total,5,52,81,39,18,195,3,51,26,9,9,98,293,GA
GOA,2011,Total Salaried,0,19,25,9,0,53,0,7,1,0,0,8,61,GA
GOA,2011,Total Self-employed,1,3,6,5,3,18,0,1,0,0,0,1,19,GA
GUJARAT,2011,Others (Please Specify),8,387,416,244,78,1133,8,130,121,63,28,350,1483,GJ
GUJARAT,2011,House Wife,0,0,0,0,0,0,4,719,512,258,78,1571,1571,GJ
GUJARAT,2011,Service (Government),0,18,26,16,0,60,0,7,2,2,3,14,74,GJ
GUJARAT,2011,Service (Private),0,226,226,119,10,581,0,39,31,17,5,92,673,GJ
GUJARAT,2011,Public Sector Undertaking,0,31,35,24,8,98,0,8,9,9,0,26,124,GJ
GUJARAT,2011,Student,24,146,8,0,0,178,36,110,2,0,0,148,326,GJ
GUJARAT,2011,Unemployed,2,163,182,82,14,443,0,24,18,6,0,48,491,GJ
GUJARAT,2011,Self-employed (Business activity),0,107,130,61,14,312,0,0,1,0,0,1,313,GJ
GUJARAT,2011,Professional Activity,0,210,185,107,29,531,2,31,24,2,2,61,592,GJ
GUJARAT,2011,Farming/Agriculture Activity,1,133,189,118,32,473,3,25,35,31,11,105,578,GJ
GUJARAT,2011,Retired Person,0,3,1,29,70,103,0,0,0,11,43,54,157,GJ
GUJARAT,2011,Total,35,1424,1398,800,255,3912,53,1093,755,399,170,2470,6382,GJ
GUJARAT,2011,Total Salaried,0,275,287,159,18,739,0,54,42,28,8,132,871,GJ
GUJARAT,2011,Total Self-employed,2,664,772,425,106,1969,8,114,121,61,21,325,2294,GJ
HARYANA,2011,Others (Please Specify),52,491,451,223,63,1280,21,89,63,24,7,204,1484,HR
HARYANA,2011,House Wife,0,0,0,0,0,0,0,203,148,56,9,416,416,HR
HARYANA,2011,Service (Government),0,20,28,24,0,72,0,2,5,0,0,7,79,HR
HARYANA,2011,Service (Private),0,75,91,22,5,193,0,11,7,2,0,20,213,HR
HARYANA,2011,Public Sector Undertaking,0,9,9,2,0,20,0,5,0,0,0,5,25,HR
HARYANA,2011,Student,14,105,5,5,0,129,4,47,0,0,0,51,180,HR
HARYANA,2011,Unemployed,4,91,146,75,16,332,0,15,11,17,1,44,376,HR
HARYANA,2011,Self-employed (Business activity),0,21,29,12,0,62,0,0,0,0,0,0,62,HR
HARYANA,2011,Professional Activity,0,8,13,3,0,24,0,0,0,0,0,0,24,HR
HARYANA,2011,Farming/Agriculture Activity,0,140,113,74,23,350,0,8,18,8,0,34,384,HR
HARYANA,2011,Retired Person,0,1,0,1,0,2,0,0,0,0,0,0,2,HR
HARYANA,2011,Total,70,961,885,441,107,2464,25,380,252,107,17,781,3245,HR
HARYANA,2011,Total Salaried,0,104,128,48,5,285,0,18,12,2,0,32,317,HR
HARYANA,2011,Total Self-employed,0,249,243,150,36,678,6,13,23,10,0,52,730,HR
HIMACHAL PRADESH,2011,Others (Please Specify),3,34,29,11,15,92,2,12,19,13,7,53,145,HP
HIMACHAL PRADESH,2011,House Wife,0,0,0,0,0,0,0,23,29,11,2,65,65,HP
HIMACHAL PRADESH,2011,Service (Government),0,1,5,4,0,10,0,0,2,1,0,3,13,HP
HIMACHAL PRADESH,2011,Service (Private),0,17,15,8,1,41,0,1,3,1,0,5,46,HP
HIMACHAL PRADESH,2011,Public Sector Undertaking,0,6,10,4,1,21,0,2,2,2,1,7,28,HP
HIMACHAL PRADESH,2011,Student,2,20,0,0,0,22,3,21,0,0,0,24,46,HP
HIMACHAL PRADESH,2011,Unemployed,0,9,7,0,1,17,0,4,2,0,0,6,23,HP
HIMACHAL PRADESH,2011,Self-employed (Business activity),0,3,7,7,2,19,0,0,3,1,1,5,24,HP
HIMACHAL PRADESH,2011,Professional Activity,0,0,1,2,2,5,0,0,2,0,0,2,7,HP
HIMACHAL PRADESH,2011,Farming/Agriculture Activity,0,8,14,10,10,42,0,3,0,1,0,4,46,HP
HIMACHAL PRADESH,2011,Retired Person,0,0,0,0,0,0,0,0,0,0,0,0,0,HP
HIMACHAL PRADESH,2011,Total,5,98,88,46,32,269,5,66,62,30,11,174,443,HP
HIMACHAL PRADESH,2011,Total Salaried,0,24,30,16,2,72,0,3,7,4,1,15,87,HP
HIMACHAL PRADESH,2011,Total Self-employed,0,24,32,25,20,101,1,5,14,7,5,32,133,HP
JAMMU & KASHMIR,2011,Others (Please Specify),2,21,16,15,2,56,2,20,4,2,1,29,85,JK
JAMMU & KASHMIR,2011,House Wife,0,0,0,0,0,0,0,22,29,7,0,58,58,JK
JAMMU & KASHMIR,2011,Service (Government),0,1,7,1,0,9,0,1,2,1,0,4,13,JK
JAMMU & KASHMIR,2011,Service (Private),0,4,3,2,0,9,0,1,1,0,0,2,11,JK
JAMMU & KASHMIR,2011,Public Sector Undertaking,0,0,2,2,0,4,0,0,0,0,0,0,4,JK
JAMMU & KASHMIR,2011,Student,2,9,2,0,0,13,3,24,0,0,0,27,40,JK
JAMMU & KASHMIR,2011,Unemployed,0,2,12,4,0,18,0,15,3,0,0,18,36,JK
JAMMU & KASHMIR,2011,Self-employed (Business activity),0,2,6,4,1,13,0,2,0,0,0,2,15,JK
JAMMU & KASHMIR,2011,Professional Activity,0,1,2,3,1,7,0,0,0,0,0,0,7,JK
JAMMU & KASHMIR,2011,Farming/Agriculture Activity,0,0,3,6,2,11,0,2,0,1,0,3,14,JK
JAMMU & KASHMIR,2011,Retired Person,0,0,0,2,2,4,0,0,0,0,0,0,4,JK
JAMMU & KASHMIR,2011,Total,4,40,53,39,8,144,5,87,39,11,1,143,287,JK
JAMMU & KASHMIR,2011,Total Salaried,0,5,12,5,0,22,0,2,3,1,0,6,28,JK
JAMMU & KASHMIR,2011,Total Self-employed,0,12,17,16,5,50,0,17,2,1,1,21,71,JK
JHARKHAND,2011,Others (Please Specify),3,183,65,96,35,382,1,60,18,14,1,94,476,JH
JHARKHAND,2011,House Wife,0,0,0,0,0,0,10,70,95,24,7,206,206,JH
JHARKHAND,2011,Service (Government),0,4,8,3,0,15,0,2,3,2,0,7,22,JH
JHARKHAND,2011,Service (Private),0,25,63,17,0,105,0,6,2,1,0,9,114,JH
JHARKHAND,2011,Public Sector Undertaking,7,12,1,0,0,20,1,10,0,0,0,11,31,JH
JHARKHAND,2011,Student,3,37,11,0,0,51,6,34,4,0,0,44,95,JH
JHARKHAND,2011,Unemployed,0,23,44,17,1,85,0,2,1,2,1,6,91,JH
JHARKHAND,2011,Self-employed (Business activity),0,5,11,5,0,21,0,0,0,0,0,0,21,JH
JHARKHAND,2011,Professional Activity,0,15,16,17,1,49,0,3,3,0,0,6,55,JH
JHARKHAND,2011,Farming/Agriculture Activity,0,19,44,24,3,90,0,2,1,1,0,4,94,JH
JHARKHAND,2011,Retired Person,0,1,0,0,6,7,0,0,0,0,0,0,7,JH
JHARKHAND,2011,Total,13,324,263,179,46,825,18,189,127,44,9,387,1212,JH
JHARKHAND,2011,Total Salaried,7,41,72,20,0,140,1,18,5,3,0,27,167,JH
JHARKHAND,2011,Total Self-employed,0,74,83,57,8,222,0,13,14,7,0,34,256,JH
KARNATAKA,2011,Others (Please Specify),151,803,1116,842,367,3279,65,383,331,231,113,1123,4402,KA
KARNATAKA,2011,House Wife,0,0,0,0,0,0,0,585,635,417,139,1776,1776,KA
KARNATAKA,2011,Service (Government),0,29,73,57,1,160,0,13,10,5,3,31,191,KA
KARNATAKA,2011,Service (Private),0,180,377,159,45,761,1,107,68,35,22,233,994,KA
KARNATAKA,2011,Public Sector Undertaking,0,125,114,98,25,362,0,37,22,17,1,77,439,KA
KARNATAKA,2011,Student,68,343,10,4,0,425,19,235,21,8,3,286,711,KA
KARNATAKA,2011,Unemployed,0,256,362,154,28,800,2,86,14,14,8,124,924,KA
KARNATAKA,2011,Self-employed (Business activity),0,191,314,213,52,770,0,25,17,14,0,56,826,KA
KARNATAKA,2011,Professional Activity,1,60,48,36,21,166,1,14,6,5,4,30,196,KA
KARNATAKA,2011,Farming/Agriculture Activity,0,339,630,527,198,1694,0,127,137,126,16,406,2100,KA
KARNATAKA,2011,Retired Person,0,0,0,9,46,55,0,0,2,3,3,8,63,KA
KARNATAKA,2011,Total,220,2326,3044,2099,783,8472,88,1612,1263,875,312,4150,12622,KA
KARNATAKA,2011,Total Salaried,0,334,564,314,71,1283,1,157,100,57,26,341,1624,KA
KARNATAKA,2011,Total Self-employed,7,1028,1717,1334,442,4528,4,349,282,249,56,940,5468,KA
KERALA,2011,Others (Please Specify),1,515,1148,1464,768,3896,4,114,154,149,96,517,4413,KL
KERALA,2011,House Wife,0,0,0,0,0,0,0,238,396,320,260,1214,1214,KL
KERALA,2011,Service (Government),0,3,22,29,0,54,0,2,6,4,1,13,67,KL
KERALA,2011,Service (Private),0,79,139,119,17,354,0,27,34,17,0,78,432,KL
KERALA,2011,Public Sector Undertaking,0,6,20,25,0,51,0,0,1,1,0,2,53,KL
KERALA,2011,Student,28,61,0,0,0,89,32,125,0,0,0,157,246,KL
KERALA,2011,Unemployed,0,94,165,117,54,430,0,54,40,10,11,115,545,KL
KERALA,2011,Self-employed (Business activity),0,42,119,141,51,353,0,0,1,6,0,7,360,KL
KERALA,2011,Professional Activity,0,26,71,43,15,155,0,7,3,2,0,12,167,KL
KERALA,2011,Farming/Agriculture Activity,0,101,215,230,186,732,0,21,25,34,18,98,830,KL
KERALA,2011,Retired Person,0,0,1,41,56,98,0,0,0,2,4,6,104,KL
KERALA,2011,Total,29,927,1900,2209,1147,6212,36,588,660,545,390,2219,8431,KL
KERALA,2011,Total Salaried,0,88,181,173,17,459,0,29,41,22,1,93,552,KL
KERALA,2011,Total Self-employed,0,508,1109,1146,694,3457,2,101,132,117,58,410,3867,KL
LAKSHADWEEP,2011,Others (Please Specify),0,0,0,0,0,0,0,0,0,0,0,0,0,LD
LAKSHADWEEP,2011,House Wife,0,0,0,0,0,0,0,0,0,0,0,0,0,LD
LAKSHADWEEP,2011,Service (Government),0,0,0,0,0,0,0,0,0,0,0,0,0,LD
LAKSHADWEEP,2011,Service (Private),0,0,0,0,0,0,0,0,0,0,0,0,0,LD
LAKSHADWEEP,2011,Public Sector Undertaking,0,0,0,0,0,0,0,0,0,0,0,0,0,LD
LAKSHADWEEP,2011,Student,0,0,0,0,0,0,0,0,0,0,0,0,0,LD
LAKSHADWEEP,2011,Unemployed,0,0,0,0,0,0,0,0,0,0,0,0,0,LD
LAKSHADWEEP,2011,Self-employed (Business activity),0,0,0,0,0,0,0,0,0,0,0,0,0,LD
LAKSHADWEEP,2011,Professional Activity,0,0,0,0,0,0,0,0,0,0,0,0,0,LD
LAKSHADWEEP,2011,Farming/Agriculture Activity,0,0,0,0,0,0,0,0,0,0,0,0,0,LD
LAKSHADWEEP,2011,Retired Person,0,0,0,0,0,0,0,0,0,0,0,0,0,LD
LAKSHADWEEP,2011,Total,0,0,0,0,0,0,0,0,0,0,0,0,0,LD
LAKSHADWEEP,2011,Total Salaried,0,0,0,0,0,0,0,0,0,0,0,0,0,LD
LAKSHADWEEP,2011,Total Self-employed,0,0,0,0,0,0,0,0,0,0,0,0,0,LD
MADHYA PRADESH,2011,Others (Please Specify),87,815,690,400,199,2191,96,301,172,81,27,677,2868,MP
MADHYA PRADESH,2011,House Wife,0,0,0,0,0,0,14,1403,863,305,147,2732,2732,MP
MADHYA PRADESH,2011,Service (Government),0,20,44,31,0,95,0,10,5,2,0,17,112,MP
MADHYA PRADESH,2011,Service (Private),0,166,198,115,17,496,0,45,21,8,1,75,571,MP
MADHYA PRADESH,2011,Public Sector Undertaking,0,37,57,23,8,125,2,15,16,3,1,37,162,MP
MADHYA PRADESH,2011,Student,53,202,10,0,0,265,39,139,8,0,0,186,451,MP
MADHYA PRADESH,2011,Unemployed,6,107,80,15,5,213,6,32,9,3,0,50,263,MP
MADHYA PRADESH,2011,Self-employed (Business activity),0,156,177,90,32,455,0,5,1,3,0,9,464,MP
MADHYA PRADESH,2011,Professional Activity,0,103,57,56,32,248,0,6,5,6,2,19,267,MP
MADHYA PRADESH,2011,Farming/Agriculture Activity,10,366,446,184,126,1132,6,84,84,15,5,194,1326,MP
MADHYA PRADESH,2011,Retired Person,0,5,0,2,13,20,0,16,3,3,1,23,43,MP
MADHYA PRADESH,2011,Total,156,1977,1759,916,432,5240,163,2056,1187,429,184,4019,9259,MP
MADHYA PRADESH,2011,Total Salaried,0,223,299,169,25,716,2,70,42,13,2,129,845,MP
MADHYA PRADESH,2011,Total Self-employed,54,1110,1096,582,319,3161,64,289,232,78,27,690,3851,MP
MAHARASHTRA,2011,Others (Please Specify),10,942,1177,676,402,3207,6,124,80,53,20,283,3490,MH
MAHARASHTRA,2011,House Wife,0,0,0,0,0,0,10,1863,1152,429,262,3716,3716,MH
MAHARASHTRA,2011,Service (Government),0,35,74,59,2,170,0,13,10,2,0,25,195,MH
MAHARASHTRA,2011,Service (Private),1,633,738,363,62,1797,0,82,46,8,1,137,1934,MH
MAHARASHTRA,2011,Public Sector Undertaking,0,19,33,21,3,76,0,5,4,1,0,10,86,MH
MAHARASHTRA,2011,Student,33,441,7,0,0,481,60,437,10,0,0,507,988,MH
MAHARASHTRA,2011,Unemployed,0,299,203,71,18,591,3,50,7,6,1,67,658,MH
MAHARASHTRA,2011,Self-employed (Business activity),0,168,248,150,12,578,0,11,14,7,0,32,610,MH
MAHARASHTRA,2011,Professional Activity,0,209,288,185,68,750,0,20,7,8,1,36,786,MH
MAHARASHTRA,2011,Farming/Agriculture Activity,2,727,1186,808,370,3093,1,123,92,19,9,244,3337,MH
MAHARASHTRA,2011,Retired Person,0,4,6,16,118,144,0,0,0,1,2,3,147,MH
MAHARASHTRA,2011,Total,46,3477,3960,2349,1055,10887,80,2728,1422,534,296,5060,15947,MH
MAHARASHTRA,2011,Total Salaried,1,687,845,443,67,2043,0,100,60,11,1,172,2215,MH
MAHARASHTRA,2011,Total Self-employed,9,1912,2717,1708,796,7142,6,264,184,85,28,567,7709,MH
MANIPUR,2011,Others (Please Specify),0,1,0,1,0,2,0,6,0,0,0,6,8,MN
MANIPUR,2011,House Wife,0,0,0,0,0,0,0,6,2,1,0,9,9,MN
MANIPUR,2011,Service (Government),0,0,4,1,0,5,0,0,0,0,0,0,5,MN
MANIPUR,2011,Service (Private),0,0,1,0,0,1,0,0,0,0,0,0,1,MN
MANIPUR,2011,Public Sector Undertaking,0,0,0,0,0,0,0,0,0,0,0,0,0,MN
MANIPUR,2011,Student,0,4,0,0,0,4,0,0,0,0,0,0,4,MN
MANIPUR,2011,Unemployed,0,1,4,1,0,6,0,0,0,0,0,0,6,MN
MANIPUR,2011,Self-employed (Business activity),0,0,0,0,0,0,0,0,0,0,0,0,0,MN
MANIPUR,2011,Professional Activity,0,0,0,0,0,0,0,0,0,0,0,0,0,MN
MANIPUR,2011,Farming/Agriculture Activity,0,0,0,0,0,0,0,0,0,0,0,0,0,MN
MANIPUR,2011,Retired Person,0,0,0,0,0,0,0,0,0,0,0,0,0,MN
MANIPUR,2011,Total,0,6,9,3,0,18,0,12,2,1,0,15,33,MN
MANIPUR,2011,Total Salaried,0,0,5,1,0,6,0,0,0,0,0,0,6,MN
MANIPUR,2011,Total Self-employed,0,0,0,1,0,1,0,1,0,0,0,1,2,MN
MEGHALAYA,2011,Others (Please Specify),1,9,6,4,0,20,1,2,0,1,2,6,26,ML
MEGHALAYA,2011,House Wife,0,0,0,0,0,0,0,5,8,2,0,15,15,ML
MEGHALAYA,2011,Service (Government),0,2,3,1,0,6,0,0,0,0,0,0,6,ML
MEGHALAYA,2011,Service (Private),0,6,1,0,0,7,0,0,1,0,0,1,8,ML
MEGHALAYA,2011,Public Sector Undertaking,0,0,1,0,1,2,0,0,0,0,0,0,2,ML
MEGHALAYA,2011,Student,3,25,0,0,0,28,0,9,0,0,0,9,37,ML
MEGHALAYA,2011,Unemployed,0,12,6,0,0,18,0,1,2,0,0,3,21,ML
MEGHALAYA,2011,Self-employed (Business activity),0,3,2,5,0,10,0,0,0,0,0,0,10,ML
MEGHALAYA,2011,Professional Activity,0,4,0,0,0,4,0,0,0,2,0,2,6,ML
MEGHALAYA,2011,Farming/Agriculture Activity,0,6,6,3,1,16,0,4,2,0,0,6,22,ML
MEGHALAYA,2011,Retired Person,0,0,0,0,0,0,0,0,0,0,0,0,0,ML
MEGHALAYA,2011,Total,4,67,25,13,2,111,1,21,13,5,2,42,153,ML
MEGHALAYA,2011,Total Salaried,0,8,5,1,1,15,0,0,1,0,0,1,16,ML
MEGHALAYA,2011,Total Self-employed,0,17,11,11,1,40,0,5,2,3,2,12,52,ML
MIZORAM,2011,Others (Please Specify),0,9,9,0,0,18,0,2,0,1,0,3,21,MZ
MIZORAM,2011,House Wife,0,0,0,0,0,0,0,0,5,1,0,6,6,MZ
MIZORAM,2011,Service (Government),0,0,1,3,0,4,0,0,0,0,0,0,4,MZ
MIZORAM,2011,Service (Private),0,0,3,0,0,3,0,0,0,0,0,0,3,MZ
MIZORAM,2011,Public Sector Undertaking,0,0,0,0,0,0,0,1,0,0,0,1,1,MZ
MIZORAM,2011,Student,2,10,0,0,0,12,0,1,0,0,0,1,13,MZ
MIZORAM,2011,Unemployed,0,15,11,0,0,26,0,1,0,0,0,1,27,MZ
MIZORAM,2011,Self-employed (Business activity),0,0,0,0,0,0,0,0,0,0,0,0,0,MZ
MIZORAM,2011,Professional Activity,0,0,0,0,0,0,0,0,0,0,0,0,0,MZ
MIZORAM,2011,Farming/Agriculture Activity,0,3,5,4,1,13,0,0,1,0,0,1,14,MZ
MIZORAM,2011,Retired Person,0,0,0,0,1,1,0,0,0,0,0,0,1,MZ
MIZORAM,2011,Total,2,37,29,7,2,77,0,5,6,2,0,13,90,MZ
MIZORAM,2011,Total Salaried,0,0,4,3,0,7,0,1,0,0,0,1,8,MZ
MIZORAM,2011,Total Self-employed,0,9,9,4,1,23,0,2,1,1,0,4,27,MZ
NAGALAND,2011,Others (Please Specify),0,3,0,2,0,5,0,2,0,0,0,2,7,NG
NAGALAND,2011,House Wife,0,0,0,0,0,0,0,2,2,0,0,4,4,NG
NAGALAND,2011,Service (Government),0,1,6,0,0,7,0,0,0,0,0,0,7,NG
NAGALAND,2011,Service (Private),0,0,0,0,0,0,0,0,0,0,0,0,0,NG
NAGALAND,2011,Public Sector Undertaking,0,0,0,0,0,0,0,0,0,0,0,0,0,NG
NAGALAND,2011,Student,0,0,0,0,0,0,0,2,0,0,0,2,2,NG
NAGALAND,2011,Unemployed,0,0,1,0,0,1,0,0,0,0,0,0,1,NG
NAGALAND,2011,Self-employed (Business activity),0,0,1,0,0,1,0,0,0,0,0,0,1,NG
NAGALAND,2011,Professional Activity,0,1,3,5,0,9,0,0,0,0,0,0,9,NG
NAGALAND,2011,Farming/Agriculture Activity,0,1,0,1,0,2,0,0,0,0,0,0,2,NG
NAGALAND,2011,Retired Person,0,0,0,0,0,0,0,0,0,0,0,0,0,NG
NAGALAND,2011,Total,0,6,11,8,0,25,0,6,2,0,0,8,33,NG
NAGALAND,2011,Total Salaried,0,1,6,0,0,7,0,0,0,0,0,0,7,NG
NAGALAND,2011,Total Self-employed,0,5,4,8,0,17,0,2,0,0,0,2,19,NG
ODISHA,2011,Others (Please Specify),71,429,418,319,163,1400,73,258,252,170,80,833,2233,OD
ODISHA,2011,House Wife,0,0,0,0,0,0,0,352,314,132,31,829,829,OD
ODISHA,2011,Service (Government),0,5,13,16,0,34,0,2,3,3,0,8,42,OD
ODISHA,2011,Service (Private),4,96,154,69,11,334,0,37,41,14,3,95,429,OD
ODISHA,2011,Public Sector Undertaking,0,54,65,23,1,143,0,15,13,5,0,33,176,OD
ODISHA,2011,Student,36,163,9,0,0,208,37,117,6,0,0,160,368,OD
ODISHA,2011,Unemployed,32,149,149,49,2,381,11,65,48,19,6,149,530,OD
ODISHA,2011,Self-employed (Business activity),1,56,110,98,10,275,0,21,21,6,1,49,324,OD
ODISHA,2011,Professional Activity,0,29,64,17,2,112,0,5,4,0,0,9,121,OD
ODISHA,2011,Farming/Agriculture Activity,0,35,44,52,7,138,0,0,3,3,0,6,144,OD
ODISHA,2011,Retired Person,0,0,0,4,31,35,0,0,0,4,6,10,45,OD
ODISHA,2011,Total,144,1016,1026,647,227,3060,121,872,705,356,127,2181,5241,OD
ODISHA,2011,Total Salaried,4,155,232,108,12,511,0,54,57,22,3,136,647,OD
ODISHA,2011,Total Self-employed,59,445,527,403,145,1579,56,167,191,128,64,606,2185,OD
PUDUCHERRY,2011,Others (Please Specify),0,6,16,11,2,35,0,0,0,0,0,0,35,PY
PUDUCHERRY,2011,House Wife,0,0,0,0,0,0,0,45,30,15,7,97,97,PY
PUDUCHERRY,2011,Service (Government),0,1,4,5,0,10,0,1,0,0,0,1,11,PY
PUDUCHERRY,2011,Service (Private),0,15,12,13,2,42,0,6,2,0,0,8,50,PY
PUDUCHERRY,2011,Public Sector Undertaking,0,2,1,2,0,5,0,1,0,1,0,2,7,PY
PUDUCHERRY,2011,Student,2,14,0,0,0,16,7,13,0,0,0,20,36,PY
PUDUCHERRY,2011,Unemployed,0,13,15,19,25,72,0,19,2,1,10,32,104,PY
PUDUCHERRY,2011,Self-employed (Business activity),0,10,17,18,1,46,0,1,0,0,0,1,47,PY
PUDUCHERRY,2011,Professional Activity,0,32,79,54,5,170,0,0,0,0,0,0,170,PY
PUDUCHERRY,2011,Farming/Agriculture Activity,0,0,0,0,0,0,0,0,0,0,0,0,0,PY
PUDUCHERRY,2011,Retired Person,0,0,0,0,0,0,0,0,0,0,0,0,0,PY
PUDUCHERRY,2011,Total,2,93,144,122,35,396,7,86,34,17,17,161,557,PY
PUDUCHERRY,2011,Total Salaried,0,18,17,20,2,57,0,8,2,1,0,11,68,PY
PUDUCHERRY,2011,Total Self-employed,0,48,112,83,8,251,0,1,0,0,0,1,252,PY
PUNJAB,2011,Others (Please Specify),0,90,121,49,30,290,0,11,9,2,0,22,312,PN
PUNJAB,2011,House Wife,0,0,0,0,0,0,0,72,61,10,5,148,148,PN
PUNJAB,2011,Service (Government),0,13,20,10,0,43,0,0,0,0,0,0,43,PN
PUNJAB,2011,Service (Private),0,52,58,31,7,148,0,6,0,0,0,6,154,PN
PUNJAB,2011,Public Sector Undertaking,0,5,2,1,0,8,0,6,2,0,0,8,16,PN
PUNJAB,2011,Student,0,20,1,0,0,21,0,17,0,0,0,17,38,PN
PUNJAB,2011,Unemployed,0,48,26,12,8,94,0,4,2,0,0,6,100,PN
PUNJAB,2011,Self-employed (Business activity),0,10,16,4,1,31,0,0,0,0,0,0,31,PN
PUNJAB,2011,Professional Activity,0,3,11,2,1,17,0,0,0,0,0,0,17,PN
PUNJAB,2011,Farming/Agriculture Activity,0,33,34,14,13,94,0,0,1,3,0,4,98,PN
PUNJAB,2011,Retired Person,0,0,2,2,5,9,0,0,0,0,0,0,9,PN
PUNJAB,2011,Total,0,274,291,125,65,755,0,116,75,15,5,211,966,PN
PUNJAB,2011,Total Salaried,0,70,80,42,7,199,0,12,2,0,0,14,213,PN
PUNJAB,2011,Total Self-employed,0,89,115,47,35,286,0,6,5,5,0,16,302,PN
RAJASTHAN,2011,Others (Please Specify),40,589,642,425,79,1775,10,168,102,43,15,338,2113,RJ
RAJASTHAN,2011,House Wife,0,0,0,0,0,0,9,341,306,101,27,784,784,RJ
RAJASTHAN,2011,Service (Government),0,5,16,13,1,35,0,1,6,1,0,8,43,RJ
RAJASTHAN,2011,Service (Private),0,196,142,68,7,413,0,21,17,5,2,45,458,RJ
RAJASTHAN,2011,Public Sector Undertaking,0,7,8,8,2,25,0,2,3,0,0,5,30,RJ
RAJASTHAN,2011,Student,23,128,6,0,0,157,8,68,3,0,0,79,236,RJ
RAJASTHAN,2011,Unemployed,0,63,42,9,0,114,0,9,4,1,0,14,128,RJ
RAJASTHAN,2011,Self-employed (Business activity),0,53,71,34,3,161,0,6,7,1,0,14,175,RJ
RAJASTHAN,2011,Professional Activity,0,31,51,20,2,104,0,1,0,0,0,1,105,RJ
RAJASTHAN,2011,Farming/Agriculture Activity,0,77,77,59,11,224,0,20,15,8,1,44,268,RJ
RAJASTHAN,2011,Retired Person,0,0,1,3,4,8,0,0,0,0,0,0,8,RJ
RAJASTHAN,2011,Total,63,1149,1056,639,109,3016,27,637,463,160,45,1332,4348,RJ
RAJASTHAN,2011,Total Salaried,0,208,166,89,10,473,0,24,26,6,2,58,531,RJ
RAJASTHAN,2011,Total Self-employed,6,413,517,246,45,1227,2,93,51,20,4,170,1397,RJ
SIKKIM,2011,Others (Please Specify),4,8,4,7,2,25,2,3,9,4,3,21,46,SK
SIKKIM,2011,House Wife,0,0,0,0,0,0,0,7,3,2,0,12,12,SK
SIKKIM,2011,Service (Government),0,9,2,1,0,12,0,2,0,0,0,2,14,SK
SIKKIM,2011,Service (Private),0,11,5,4,0,20,0,10,0,1,0,11,31,SK
SIKKIM,2011,Public Sector Undertaking,0,6,8,0,0,14,0,2,0,2,0,4,18,SK
SIKKIM,2011,Student,0,2,1,0,0,3,0,4,0,0,0,4,7,SK
SIKKIM,2011,Unemployed,0,3,9,5,0,17,0,1,3,5,0,9,26,SK
SIKKIM,2011,Self-employed (Business activity),0,1,2,3,0,6,0,3,2,0,0,5,11,SK
SIKKIM,2011,Professional Activity,0,0,1,0,0,1,0,0,2,2,0,4,5,SK
SIKKIM,2011,Farming/Agriculture Activity,0,0,4,3,0,7,0,0,3,2,0,5,12,SK
SIKKIM,2011,Retired Person,0,0,0,2,0,2,0,0,0,0,0,0,2,SK
SIKKIM,2011,Total,4,40,36,25,2,107,2,32,22,18,3,77,184,SK
SIKKIM,2011,Total Salaried,0,26,15,5,0,46,0,14,0,3,0,17,63,SK
SIKKIM,2011,Total Self-employed,0,5,8,11,0,24,0,3,14,7,0,24,48,SK
TAMIL NADU,2011,Others (Please Specify),46,1313,2177,997,599,5132,95,764,595,215,131,1800,6932,TN
TAMIL NADU,2011,House Wife,0,0,0,0,0,0,5,915,888,407,218,2433,2433,TN
TAMIL NADU,2011,Service (Government),0,11,52,53,4,120,0,11,18,5,3,37,157,TN
TAMIL NADU,2011,Service (Private),0,287,449,257,45,1038,1,96,81,48,1,227,1265,TN
TAMIL NADU,2011,Public Sector Undertaking,1,38,50,34,7,130,0,31,16,3,1,51,181,TN
TAMIL NADU,2011,Student,95,324,61,0,0,480,78,273,18,0,0,369,849,TN
TAMIL NADU,2011,Unemployed,14,408,596,599,146,1763,15,239,114,85,18,471,2234,TN
TAMIL NADU,2011,Self-employed (Business activity),0,187,281,203,58,729,0,11,30,7,1,49,778,TN
TAMIL NADU,2011,Professional Activity,0,69,144,81,33,327,0,18,23,28,25,94,421,TN
TAMIL NADU,2011,Farming/Agriculture Activity,3,99,161,157,62,482,2,61,43,23,12,141,623,TN
TAMIL NADU,2011,Retired Person,0,0,6,24,51,81,0,0,0,5,4,9,90,TN
TAMIL NADU,2011,Total,159,2736,3977,2405,1005,10282,196,2419,1826,826,414,5681,15963,TN
TAMIL NADU,2011,Total Salaried,1,336,551,344,56,1288,1,138,115,56,5,315,1603,TN
TAMIL NADU,2011,Total Self-employed,13,827,1320,969,373,3502,13,289,265,156,71,794,4296,TN
TRIPURA,2011,Others (Please Specify),3,75,85,36,24,223,0,27,6,1,0,34,257,TR
TRIPURA,2011,House Wife,0,0,0,0,0,0,0,29,47,37,27,140,140,TR
TRIPURA,2011,Service (Government),0,0,2,1,0,3,0,0,0,0,0,0,3,TR
TRIPURA,2011,Service (Private),0,10,6,3,1,20,0,0,0,0,0,0,20,TR
TRIPURA,2011,Public Sector Undertaking,0,0,0,0,0,0,0,0,0,0,0,0,0,TR
TRIPURA,2011,Student,2,78,0,0,0,80,5,77,0,0,0,82,162,TR
TRIPURA,2011,Unemployed,0,1,1,0,0,2,0,0,0,0,0,0,2,TR
TRIPURA,2011,Self-employed (Business activity),0,33,30,24,12,99,0,0,0,0,0,0,99,TR
TRIPURA,2011,Professional Activity,0,0,0,0,0,0,0,0,0,0,0,0,0,TR
TRIPURA,2011,Farming/Agriculture Activity,0,5,9,4,2,20,0,0,0,0,0,0,20,TR
TRIPURA,2011,Retired Person,0,0,0,0,0,0,0,0,0,0,0,0,0,TR
TRIPURA,2011,Total,5,202,133,68,39,447,5,133,53,38,27,256,703,TR
TRIPURA,2011,Total Salaried,0,10,8,4,1,23,0,0,0,0,0,0,23,TR
TRIPURA,2011,Total Self-employed,0,43,51,31,23,148,0,4,2,1,0,7,155,TR
UTTAR PRADESH,2011,Others (Please Specify),23,350,435,248,85,1141,12,202,157,63,28,462,1603,UP
UTTAR PRADESH,2011,House Wife,0,0,0,0,0,0,24,739,327,109,45,1244,1244,UP
UTTAR PRADESH,2011,Service (Government),0,11,21,16,0,48,0,22,17,2,0,41,89,UP
UTTAR PRADESH,2011,Service (Private),0,133,127,57,2,319,0,29,46,4,0,79,398,UP
UTTAR PRADESH,2011,Public Sector Undertaking,0,4,4,8,0,16,0,2,2,0,0,4,20,UP
UTTAR PRADESH,2011,Student,17,122,10,4,0,153,16,89,1,0,0,106,259,UP
UTTAR PRADESH,2011,Unemployed,1,132,86,29,11,259,3,22,27,9,2,63,322,UP
UTTAR PRADESH,2011,Self-employed (Business activity),1,33,59,10,2,105,0,27,0,0,0,27,132,UP
UTTAR PRADESH,2011,Professional Activity,0,30,54,27,2,113,0,4,3,2,0,9,122,UP
UTTAR PRADESH,2011,Farming/Agriculture Activity,3,152,199,118,81,553,4,32,36,12,8,92,645,UP
UTTAR PRADESH,2011,Retired Person,0,0,2,1,3,6,0,2,0,0,1,3,9,UP
UTTAR PRADESH,2011,Total,45,967,997,518,186,2713,59,1170,616,201,84,2130,4843,UP
UTTAR PRADESH,2011,Total Salaried,0,148,152,81,2,383,0,53,65,6,0,124,507,UP
UTTAR PRADESH,2011,Total Self-employed,13,368,513,272,121,1287,10,160,121,53,22,366,1653,UP
UTTARAKHAND,2011,Others (Please Specify),1,12,21,9,3,46,0,15,15,7,0,37,83,UK
UTTARAKHAND,2011,House Wife,0,0,0,0,0,0,0,23,24,3,1,51,51,UK
UTTARAKHAND,2011,Service (Government),0,5,9,3,0,17,0,2,0,0,0,2,19,UK
UTTARAKHAND,2011,Service (Private),0,11,18,2,0,31,0,4,2,0,0,6,37,UK
UTTARAKHAND,2011,Public Sector Undertaking,0,2,1,1,1,5,0,4,0,0,0,4,9,UK
UTTARAKHAND,2011,Student,3,9,1,0,0,13,1,16,0,0,0,17,30,UK
UTTARAKHAND,2011,Unemployed,1,12,13,7,3,36,0,3,2,0,0,5,41,UK
UTTARAKHAND,2011,Self-employed (Business activity),0,7,5,3,0,15,0,0,0,0,0,0,15,UK
UTTARAKHAND,2011,Professional Activity,0,1,2,0,0,3,0,0,0,0,0,0,3,UK
UTTARAKHAND,2011,Farming/Agriculture Activity,0,10,2,9,1,22,0,2,1,0,0,3,25,UK
UTTARAKHAND,2011,Retired Person,0,0,1,0,3,4,0,0,0,0,0,0,4,UK
UTTARAKHAND,2011,Total,5,69,73,34,11,192,1,69,44,10,1,125,317,UK
UTTARAKHAND,2011,Total Salaried,0,18,28,6,1,53,0,10,2,0,0,12,65,UK
UTTARAKHAND,2011,Total Self-employed,1,25,20,16,4,66,0,7,9,5,0,21,87,UK
WEST BENGAL,2011,Others (Please Specify),192,972,1714,1129,549,4556,146,708,727,476,300,2357,6913,WB
WEST BENGAL,2011,House Wife,0,0,0,0,0,0,1,1218,1171,474,91,2955,2955,WB
WEST BENGAL,2011,Service (Government),0,14,66,25,1,106,0,7,5,5,0,17,123,WB
WEST BENGAL,2011,Service (Private),0,114,235,222,1,572,0,78,66,32,0,176,748,WB
WEST BENGAL,2011,Public Sector Undertaking,0,73,245,191,0,509,0,90,61,30,2,183,692,WB
WEST BENGAL,2011,Student,92,426,9,0,0,527,96,404,7,0,0,507,1034,WB
WEST BENGAL,2011,Unemployed,0,394,638,139,24,1195,0,138,163,76,6,383,1578,WB
WEST BENGAL,2011,Self-employed (Business activity),0,353,427,257,32,1069,15,15,39,18,0,87,1156,WB
WEST BENGAL,2011,Professional Activity,0,43,165,151,8,367,0,16,18,13,0,47,414,WB
WEST BENGAL,2011,Farming/Agriculture Activity,0,132,293,182,55,662,0,39,69,37,0,145,807,WB
WEST BENGAL,2011,Retired Person,0,0,0,0,61,61,0,0,0,0,11,11,72,WB
WEST BENGAL,2011,Total,284,2521,3792,2296,731,9624,258,2713,2326,1161,410,6868,16492,WB
WEST BENGAL,2011,Total Salaried,0,201,546,438,2,1187,0,175,132,67,2,376,1563,WB
WEST BENGAL,2011,Total Self-employed,31,830,1612,1118,290,3881,51,434,422,267,58,1232,5113,WB
A & N ISLANDS,2012,Others (Please Specify),0,3,0,0,1,4,0,3,0,0,0,3,7,AN
A & N ISLANDS,2012,House Wife,0,0,0,0,0,0,0,11,11,2,4,28,28,AN
A & N ISLANDS,2012,Service (Government),0,1,5,11,1,18,0,1,1,1,0,3,21,AN
A & N ISLANDS,2012,Service (Private),0,12,21,9,7,49,0,1,0,0,0,1,50,AN
A & N ISLANDS,2012,Public Sector Undertaking,0,0,0,0,0,0,0,0,0,0,0,0,0,AN
A & N ISLANDS,2012,Student,2,2,0,0,0,4,1,4,0,0,0,5,9,AN
A & N ISLANDS,2012,Unemployed,0,4,0,0,0,4,0,1,0,0,0,1,5,AN
A & N ISLANDS,2012,Self-employed (Business activity),0,0,0,0,0,0,0,0,0,0,0,0,0,AN
A & N ISLANDS,2012,Professional Activity,0,0,0,0,0,0,0,0,0,0,0,0,0,AN
A & N ISLANDS,2012,Farming/Agriculture Activity,0,0,0,0,0,0,0,0,0,0,0,0,0,AN
A & N ISLANDS,2012,Retired Person,0,0,0,0,1,1,0,0,0,0,0,0,1,AN
A & N ISLANDS,2012,Total,2,22,26,20,10,80,1,21,12,3,4,41,121,AN
A & N ISLANDS,2012,Total Salaried,0,13,26,20,8,67,0,2,1,1,0,4,71,AN
A & N ISLANDS,2012,Total Self-employed,0,3,0,0,1,4,0,3,0,0,0,3,7,AN
ANDHRA PRADESH,2012,Others (Please Specify),30,861,1418,940,467,3716,80,540,399,212,129,1360,5076,AP
ANDHRA PRADESH,2012,House Wife,0,0,0,0,0,0,1,946,669,401,126,2143,2143,AP
ANDHRA PRADESH,2012,Service (Government),0,18,42,45,3,108,0,7,16,6,0,29,137,AP
ANDHRA PRADESH,2012,Service (Private),0,411,563,244,50,1268,0,84,67,24,10,185,1453,AP
ANDHRA PRADESH,2012,Public Sector Undertaking,0,70,124,60,26,280,0,9,38,2,2,51,331,AP
ANDHRA PRADESH,2012,Student,35,222,19,0,0,276,54,225,4,0,0,283,559,AP
ANDHRA PRADESH,2012,Unemployed,0,195,266,133,46,640,0,81,33,11,2,127,767,AP
ANDHRA PRADESH,2012,Self-employed (Business activity),0,207,300,165,49,721,0,7,19,3,1,30,751,AP
ANDHRA PRADESH,2012,Professional Activity,0,85,142,98,9,334,1,15,14,1,0,31,365,AP
ANDHRA PRADESH,2012,Farming/Agriculture Activity,0,474,753,624,249,2100,7,132,207,70,56,472,2572,AP
ANDHRA PRADESH,2012,Retired Person,0,0,1,31,52,84,0,0,0,0,0,0,84,AP
ANDHRA PRADESH,2012,Total,65,2543,3628,2340,951,9527,143,2046,1466,730,326,4711,14238,AP
ANDHRA PRADESH,2012,Total Salaried,0,499,729,349,79,1656,0,100,121,32,12,265,1921,AP
ANDHRA PRADESH,2012,Total Self-employed,11,1367,2171,1538,589,5676,57,439,505,202,143,1346,7022,AP
ARUNACHAL PRADESH,2012,Others (Please Specify),0,8,10,9,1,28,0,2,0,0,0,2,30,AR
ARUNACHAL PRADESH,2012,House Wife,0,0,0,0,0,0,0,9,9,1,0,19,19,AR
ARUNACHAL PRADESH,2012,Service (Government),0,1,1,2,0,4,0,5,0,0,0,5,9,AR
ARUNACHAL PRADESH,2012,Service (Private),0,4,13,12,0,29,0,1,0,0,0,1,30,AR
ARUNACHAL PRADESH,2012,Public Sector Undertaking,0,2,0,0,0,2,0,0,0,0,0,0,2,AR
ARUNACHAL PRADESH,2012,Student,1,9,0,0,0,10,0,3,0,0,0,3,13,AR
ARUNACHAL PRADESH,2012,Unemployed,0,3,8,5,0,16,0,0,0,0,0,0,16,AR
ARUNACHAL PRADESH,2012,Self-employed (Business activity),0,0,0,0,0,0,0,0,0,0,0,0,0,AR
ARUNACHAL PRADESH,2012,Professional Activity,0,0,0,0,0,0,0,0,0,0,0,0,0,AR
ARUNACHAL PRADESH,2012,Farming/Agriculture Activity,0,1,7,3,0,11,0,0,0,0,0,0,11,AR
ARUNACHAL PRADESH,2012,Retired Person,0,0,0,0,0,0,0,0,0,0,0,0,0,AR
ARUNACHAL PRADESH,2012,Total,1,28,39,31,1,100,0,20,9,1,0,30,130,AR
ARUNACHAL PRADESH,2012,Total Salaried,0,7,14,14,0,35,0,6,0,0,0,6,41,AR
ARUNACHAL PRADESH,2012,Total Self-employed,0,5,15,9,1,30,0,2,0,0,0,2,32,AR
ASSAM,2012,Others (Please Specify),29,265,541,313,24,1172,9,104,97,56,5,271,1443,AS
ASSAM,2012,House Wife,0,0,0,0,0,0,0,133,175,91,4,403,403,AS
ASSAM,2012,Service (Government),0,1,10,17,1,29,0,12,9,4,0,25,54,AS
ASSAM,2012,Service (Private),0,44,50,28,0,122,0,3,6,2,0,11,133,AS
ASSAM,2012,Public Sector Undertaking,0,25,51,30,1,107,0,4,4,1,0,9,116,AS
ASSAM,2012,Student,6,116,2,0,0,124,7,88,2,0,0,97,221,AS
ASSAM,2012,Unemployed,0,12,12,33,7,64,0,2,1,1,0,4,68,AS
ASSAM,2012,Self-employed (Business activity),0,99,119,102,0,320,0,12,16,5,0,33,353,AS
ASSAM,2012,Professional Activity,0,30,55,24,1,110,0,4,8,3,0,15,125,AS
ASSAM,2012,Farming/Agriculture Activity,2,103,143,80,12,340,0,0,4,0,0,4,344,AS
ASSAM,2012,Retired Person,0,0,0,0,4,4,0,0,0,0,0,0,4,AS
ASSAM,2012,Total,37,695,983,627,50,2392,16,362,322,163,9,872,3264,AS
ASSAM,2012,Total Salaried,0,70,111,75,2,258,0,19,19,7,0,45,303,AS
ASSAM,2012,Total Self-employed,21,476,741,468,33,1739,8,99,88,32,5,232,1971,AS
BIHAR,2012,Others (Please Specify),4,89,158,39,13,303,5,47,61,17,6,136,439,BR
BIHAR,2012,House Wife,0,0,0,0,0,0,0,59,55,11,5,130,130,BR
BIHAR,2012,Service (Government),0,0,2,10,0,12,0,1,2,0,0,3,15,BR
BIHAR,2012,Service (Private),0,12,5,4,1,22,0,2,0,0,0,2,24,BR
BIHAR,2012,Public Sector Undertaking,0,0,0,0,0,0,0,0,0,0,0,0,0,BR
BIHAR,2012,Student,1,29,6,0,0,36,1,22,5,0,0,28,64,BR
BIHAR,2012,Unemployed,0,3,9,1,0,13,0,0,0,1,0,1,14,BR
BIHAR,2012,Self-employed (Business activity),0,1,2,0,0,3,0,0,0,0,0,0,3,BR
BIHAR,2012,Professional Activity,0,1,0,0,0,1,0,0,0,0,0,0,1,BR
BIHAR,2012,Farming/Agriculture Activity,0,20,30,9,5,64,0,4,0,0,0,4,68,BR
BIHAR,2012,Retired Person,0,0,0,0,1,1,0,0,0,0,0,0,1,BR
BIHAR,2012,Total,5,155,212,63,20,455,6,135,123,29,11,304,759,BR
BIHAR,2012,Total Salaried,0,12,7,14,1,34,0,3,2,0,0,5,39,BR
BIHAR,2012,Total Self-employed,0,38,50,17,6,111,0,10,3,2,1,16,127,BR
CHANDIGARH,2012,Others (Please Specify),0,6,7,1,1,15,0,6,0,0,0,6,21,CH
CHANDIGARH,2012,House Wife,0,0,0,0,0,0,0,9,8,0,1,18,18,CH
CHANDIGARH,2012,Service (Government),0,1,5,2,0,8,0,0,0,0,0,0,8,CH
CHANDIGARH,2012,Service (Private),0,12,13,3,0,28,0,1,0,0,0,1,29,CH
CHANDIGARH,2012,Public Sector Undertaking,0,1,2,1,0,4,0,1,0,0,0,1,5,CH
CHANDIGARH,2012,Student,2,3,0,0,0,5,1,11,0,0,0,12,17,CH
CHANDIGARH,2012,Unemployed,0,9,3,0,0,12,0,1,0,0,0,1,13,CH
CHANDIGARH,2012,Self-employed (Business activity),0,1,1,1,0,3,0,0,0,0,0,0,3,CH
CHANDIGARH,2012,Professional Activity,0,0,0,0,0,0,0,0,0,0,0,0,0,CH
CHANDIGARH,2012,Farming/Agriculture Activity,0,0,0,0,0,0,0,0,0,0,0,0,0,CH
CHANDIGARH,2012,Retired Person,0,0,0,0,0,0,0,0,0,0,0,0,0,CH
CHANDIGARH,2012,Total,2,33,31,8,1,75,1,29,8,0,1,39,114,CH
CHANDIGARH,2012,Total Salaried,0,14,20,6,0,40,0,2,0,0,0,2,42,CH
CHANDIGARH,2012,Total Self-employed,0,7,8,2,1,18,0,3,0,0,0,3,21,CH
CHHATTISGARH,2012,Others (Please Specify),66,806,997,611,253,2733,51,269,156,96,79,651,3384,CG
CHHATTISGARH,2012,House Wife,0,0,0,0,0,0,0,353,262,125,39,779,779,CG
CHHATTISGARH,2012,Service (Government),0,6,22,34,0,62,0,3,1,0,0,4,66,CG
CHHATTISGARH,2012,Service (Private),4,133,109,85,20,351,2,25,18,9,1,55,406,CG
CHHATTISGARH,2012,Public Sector Undertaking,0,0,4,6,0,10,0,0,0,0,0,0,10,CG
CHHATTISGARH,2012,Student,13,145,3,0,0,161,25,103,1,0,0,129,290,CG
CHHATTISGARH,2012,Unemployed,0,108,131,94,8,341,0,11,3,2,2,18,359,CG
CHHATTISGARH,2012,Self-employed (Business activity),0,33,51,19,3,106,0,2,2,0,0,4,110,CG
CHHATTISGARH,2012,Professional Activity,0,72,75,63,19,229,0,0,0,0,0,0,229,CG
CHHATTISGARH,2012,Farming/Agriculture Activity,0,1,2,1,0,4,0,0,0,0,0,0,4,CG
CHHATTISGARH,2012,Retired Person,0,0,0,6,11,17,0,0,0,0,0,0,17,CG
CHHATTISGARH,2012,Total,83,1304,1394,919,314,4014,78,766,443,232,121,1640,5654,CG
CHHATTISGARH,2012,Total Salaried,4,139,135,125,20,423,2,28,19,9,1,59,482,CG
CHHATTISGARH,2012,Total Self-employed,14,522,677,515,115,1843,16,141,89,55,25,326,2169,CG
D & N HAVELI,2012,Others (Please Specify),0,3,0,0,1,4,0,2,0,0,0,2,6,DN
D & N HAVELI,2012,House Wife,0,0,0,0,0,0,0,6,2,2,3,13,13,DN
D & N HAVELI,2012,Service (Government),0,0,0,0,0,0,0,0,0,0,0,0,0,DN
D & N HAVELI,2012,Service (Private),0,11,13,2,0,26,0,2,0,0,0,2,28,DN
D & N HAVELI,2012,Public Sector Undertaking,0,0,0,0,0,0,0,0,0,0,0,0,0,DN
D & N HAVELI,2012,Student,0,0,0,0,0,0,0,6,0,0,0,6,6,DN
D & N HAVELI,2012,Unemployed,0,1,0,0,1,2,0,2,0,0,0,2,4,DN
D & N HAVELI,2012,Self-employed (Business activity),0,2,0,1,0,3,0,0,0,0,0,0,3,DN
D & N HAVELI,2012,Professional Activity,0,0,0,0,0,0,0,0,0,0,0,0,0,DN
D & N HAVELI,2012,Farming/Agriculture Activity,0,0,3,2,1,6,0,0,0,0,0,0,6,DN
D & N HAVELI,2012,Retired Person,0,0,0,0,0,0,0,0,0,0,0,0,0,DN
D & N HAVELI,2012,Total,0,17,16,5,3,41,0,18,2,2,3,25,66,DN
D & N HAVELI,2012,Total Salaried,0,11,13,2,0,26,0,2,0,0,0,2,28,DN
D & N HAVELI,2012,Total Self-employed,0,2,3,3,1,9,0,0,0,0,0,0,9,DN
DAMAN & DIU,2012,Others (Please Specify),0,4,7,4,0,15,0,2,0,0,0,2,17,DD
DAMAN & DIU,2012,House Wife,0,0,0,0,0,0,0,3,5,0,0,8,8,DD
DAMAN & DIU,2012,Service (Government),0,0,0,0,0,0,0,0,0,0,0,0,0,DD
DAMAN & DIU,2012,Service (Private),0,1,5,2,0,8,0,0,0,0,0,0,8,DD
DAMAN & DIU,2012,Public Sector Undertaking,0,0,0,0,0,0,0,0,0,0,0,0,0,DD
DAMAN & DIU,2012,Student,0,1,0,0,0,1,1,0,0,0,0,1,2,DD
DAMAN & DIU,2012,Unemployed,0,0,1,0,0,1,0,0,0,0,0,0,1,DD
DAMAN & DIU,2012,Self-employed (Business activity),0,0,0,0,0,0,0,0,0,0,0,0,0,DD
DAMAN & DIU,2012,Professional Activity,0,0,0,0,0,0,0,0,0,0,0,0,0,DD
DAMAN & DIU,2012,Farming/Agriculture Activity,0,0,0,0,0,0,0,0,0,0,0,0,0,DD
DAMAN & DIU,2012,Retired Person,0,0,0,0,0,0,0,0,0,0,0,0,0,DD
DAMAN & DIU,2012,Total,0,6,13,6,0,25,1,5,5,0,0,11,36,DD
DAMAN & DIU,2012,Total Salaried,0,1,5,2,0,8,0,0,0,0,0,0,8,DD
DAMAN & DIU,2012,Total Self-employed,0,0,1,0,0,1,0,0,0,0,0,0,1,DD
DELHI (UT),2012,Others (Please Specify),4,161,143,52,14,374,5,54,32,4,2,97,471,DL
DELHI (UT),2012,House Wife,0,0,0,0,0,0,0,194,114,36,11,355,355,DL
DELHI (UT),2012,Service (Government),0,4,10,10,0,24,0,0,0,1,0,1,25,DL
DELHI (UT),2012,Service (Private),0,120,107,35,2,264,0,14,2,0,0,16,280,DL
DELHI (UT),2012,Public Sector Undertaking,0,15,20,3,0,38,0,3,0,0,0,3,41,DL
DELHI (UT),2012,Student,19,118,0,0,0,137,22,101,6,0,0,129,266,DL
DELHI (UT),2012,Unemployed,3,177,109,27,4,320,4,43,2,0,0,49,369,DL
DELHI (UT),2012,Self-employed (Business activity),0,11,30,1,2,44,0,0,0,0,0,0,44,DL
DELHI (UT),2012,Professional Activity,0,3,3,1,0,7,0,0,3,0,0,3,10,DL
DELHI (UT),2012,Farming/Agriculture Activity,0,12,3,6,0,21,0,0,0,0,0,0,21,DL
DELHI (UT),2012,Retired Person,0,0,1,2,14,17,0,0,0,0,0,0,17,DL
DELHI (UT),2012,Total,26,621,426,137,36,1246,31,409,159,41,13,653,1899,DL
DELHI (UT),2012,Total Salaried,0,139,137,48,2,326,0,17,2,1,0,20,346,DL
DELHI (UT),2012,Total Self-employed,1,97,96,33,12,239,1,14,11,1,1,28,267,DL
GOA,2012,Others (Please Specify),2,8,23,12,4,49,1,5,3,2,1,12,61,GA
GOA,2012,House Wife,0,0,0,0,0,0,0,11,24,7,13,55,55,GA
GOA,2012,Service (Government),0,1,5,3,0,9,0,0,1,0,0,1,10,GA
GOA,2012,Service (Private),0,23,17,8,2,50,0,4,1,0,0,5,55,GA
GOA,2012,Public Sector Undertaking,0,2,2,1,1,6,0,1,1,0,0,2,8,GA
GOA,2012,Student,3,5,0,0,0,8,2,13,0,0,0,15,23,GA
GOA,2012,Unemployed,0,12,20,12,2,46,0,3,0,0,0,3,49,GA
GOA,2012,Self-employed (Business activity),0,1,10,6,1,18,0,0,0,0,0,0,18,GA
GOA,2012,Professional Activity,0,1,1,1,1,4,0,0,0,0,0,0,4,GA
GOA,2012,Farming/Agriculture Activity,0,0,0,1,0,1,0,0,0,0,0,0,1,GA
GOA,2012,Retired Person,0,0,0,0,5,5,0,0,0,0,0,0,5,GA
GOA,2012,Total,5,53,78,44,16,196,3,37,30,9,14,93,289,GA
GOA,2012,Total Salaried,0,26,24,12,3,65,0,5,3,0,0,8,73,GA
GOA,2012,Total Self-employed,0,4,20,10,2,36,0,1,0,0,1,2,38,GA
GUJARAT,2012,Others (Please Specify),18,430,483,309,94,1334,21,128,125,71,26,371,1705,GJ
GUJARAT,2012,House Wife,0,0,0,0,0,0,2,800,595,310,88,1795,1795,GJ
GUJARAT,2012,Service (Government),0,20,35,20,0,75,0,6,3,7,0,16,91,GJ
GUJARAT,2012,Service (Private),1,277,329,137,14,758,0,61,54,22,0,137,895,GJ
GUJARAT,2012,Public Sector Undertaking,0,38,52,21,4,115,0,12,17,5,1,35,150,GJ
GUJARAT,2012,Student,23,188,4,0,0,215,23,148,2,0,0,173,388,GJ
GUJARAT,2012,Unemployed,7,191,215,91,7,511,4,18,14,10,0,46,557,GJ
GUJARAT,2012,Self-employed (Business activity),0,79,105,68,13,265,0,4,0,0,0,4,269,GJ
GUJARAT,2012,Professional Activity,1,189,168,97,23,478,0,20,9,2,1,32,510,GJ
GUJARAT,2012,Farming/Agriculture Activity,2,138,193,110,29,472,4,46,23,16,3,92,564,GJ
GUJARAT,2012,Retired Person,0,4,4,29,102,139,3,3,2,6,33,47,186,GJ
GUJARAT,2012,Total,52,1554,1588,882,286,4362,57,1246,844,449,152,2748,7110,GJ
GUJARAT,2012,Total Salaried,1,335,416,178,18,948,0,79,74,34,1,188,1136,GJ
GUJARAT,2012,Total Self-employed,7,662,749,432,102,1952,9,130,78,50,15,282,2234,GJ
HARYANA,2012,Others (Please Specify),26,354,340,186,88,994,21,81,78,56,19,255,1249,HR
HARYANA,2012,House Wife,0,0,0,0,0,0,0,221,119,37,12,389,389,HR
HARYANA,2012,Service (Government),0,15,17,16,0,48,0,2,1,0,0,3,51,HR
HARYANA,2012,Service (Private),4,88,102,38,3,235,0,4,4,4,0,12,247,HR
HARYANA,2012,Public Sector Undertaking,0,25,22,5,0,52,0,1,4,0,0,5,57,HR
HARYANA,2012,Student,11,86,7,5,0,109,6,27,0,0,0,33,142,HR
HARYANA,2012,Unemployed,2,120,108,52,11,293,1,12,16,4,1,34,327,HR
HARYANA,2012,Self-employed (Business activity),0,14,20,11,0,45,0,0,0,0,0,0,45,HR
HARYANA,2012,Professional Activity,0,11,21,9,0,41,0,0,0,0,0,0,41,HR
HARYANA,2012,Farming/Agriculture Activity,0,53,100,73,25,251,0,9,12,2,2,25,276,HR
HARYANA,2012,Retired Person,0,0,0,2,1,3,0,0,0,0,0,0,3,HR
HARYANA,2012,Total,43,766,737,397,128,2071,28,357,234,103,34,756,2827,HR
HARYANA,2012,Total Salaried,4,128,141,59,3,335,0,7,9,4,0,20,355,HR
HARYANA,2012,Total Self-employed,15,310,351,203,84,963,16,64,54,23,5,162,1125,HR
HIMACHAL PRADESH,2012,Others (Please Specify),4,38,57,33,27,159,3,8,15,8,11,45,204,HP
HIMACHAL PRADESH,2012,House Wife,0,0,0,0,0,0,0,40,25,12,3,80,80,HP
HIMACHAL PRADESH,2012,Service (Government),0,0,3,3,0,6,0,2,1,1,0,4,10,HP
HIMACHAL PRADESH,2012,Service (Private),0,10,12,9,1,32,0,2,4,1,0,7,39,HP
HIMACHAL PRADESH,2012,Public Sector Undertaking,0,6,9,4,1,20,0,3,2,2,1,8,28,HP
HIMACHAL PRADESH,2012,Student,5,24,0,0,0,29,3,15,0,0,0,18,47,HP
HIMACHAL PRADESH,2012,Unemployed,1,19,14,5,1,40,0,3,1,0,0,4,44,HP
HIMACHAL PRADESH,2012,Self-employed (Business activity),0,10,10,8,4,32,0,1,2,1,0,4,36,HP
HIMACHAL PRADESH,2012,Professional Activity,0,1,2,2,1,6,0,1,1,0,0,2,8,HP
HIMACHAL PRADESH,2012,Farming/Agriculture Activity,0,4,12,8,3,27,0,0,1,1,0,2,29,HP
HIMACHAL PRADESH,2012,Retired Person,0,0,0,0,3,3,0,0,0,0,0,0,3,HP
HIMACHAL PRADESH,2012,Total,10,112,119,72,41,354,6,75,52,26,15,174,528,HP
HIMACHAL PRADESH,2012,Total Salaried,0,16,24,16,2,58,0,7,7,4,1,19,77,HP
HIMACHAL PRADESH,2012,Total Self-employed,0,23,38,29,12,102,1,2,7,6,4,20,122,HP
JAMMU & KASHMIR,2012,Others (Please Specify),0,19,30,24,8,81,1,25,14,8,17,65,146,JK
JAMMU & KASHMIR,2012,House Wife,0,0,0,0,0,0,0,29,39,6,1,75,75,JK
JAMMU & KASHMIR,2012,Service (Government),0,3,10,5,3,21,0,1,0,2,0,3,24,JK
JAMMU & KASHMIR,2012,Service (Private),0,1,3,0,1,5,0,1,1,1,10,13,18,JK
JAMMU & KASHMIR,2012,Public Sector Undertaking,0,0,0,0,0,0,0,0,0,0,0,0,0,JK
JAMMU & KASHMIR,2012,Student,2,13,5,0,0,20,1,36,0,1,4,42,62,JK
JAMMU & KASHMIR,2012,Unemployed,0,11,14,5,3,33,0,8,12,0,0,20,53,JK
JAMMU & KASHMIR,2012,Self-employed (Business activity),0,5,3,2,0,10,0,0,0,0,0,0,10,JK
JAMMU & KASHMIR,2012,Professional Activity,0,1,4,1,1,7,0,1,2,1,0,4,11,JK
JAMMU & KASHMIR,2012,Farming/Agriculture Activity,0,3,5,2,0,10,0,0,0,0,0,0,10,JK
JAMMU & KASHMIR,2012,Retired Person,0,0,0,1,4,5,0,0,0,0,0,0,5,JK
JAMMU & KASHMIR,2012,Total,2,56,74,40,20,192,2,101,68,19,32,222,414,JK
JAMMU & KASHMIR,2012,Total Salaried,0,4,13,5,4,26,0,2,1,3,10,16,42,JK
JAMMU & KASHMIR,2012,Total Self-employed,0,10,15,10,4,39,0,7,5,6,5,23,62,JK
JHARKHAND,2012,Others (Please Specify),3,93,95,94,35,320,11,61,32,13,1,118,438,JH
JHARKHAND,2012,House Wife,0,0,0,0,0,0,6,65,93,44,4,212,212,JH
JHARKHAND,2012,Service (Government),0,2,7,3,5,17,0,1,0,1,0,2,19,JH
JHARKHAND,2012,Service (Private),0,27,32,19,0,78,0,8,3,0,0,11,89,JH
JHARKHAND,2012,Public Sector Undertaking,0,6,7,0,0,13,0,4,2,0,0,6,19,JH
JHARKHAND,2012,Student,17,90,11,0,0,118,12,41,3,0,1,57,175,JH
JHARKHAND,2012,Unemployed,0,41,53,32,0,126,2,24,5,1,0,32,158,JH
JHARKHAND,2012,Self-employed (Business activity),3,9,18,11,7,48,3,6,3,5,0,17,65,JH
JHARKHAND,2012,Professional Activity,0,5,7,10,0,22,0,0,0,0,0,0,22,JH
JHARKHAND,2012,Farming/Agriculture Activity,0,24,37,29,3,93,0,7,11,6,2,26,119,JH
JHARKHAND,2012,Retired Person,0,0,0,0,3,3,0,0,0,0,0,0,3,JH
JHARKHAND,2012,Total,23,297,267,198,53,838,34,217,152,70,8,481,1319,JH
JHARKHAND,2012,Total Salaried,0,35,46,22,5,108,0,13,5,1,0,19,127,JH
JHARKHAND,2012,Total Self-employed,4,74,94,82,16,270,4,30,16,13,2,65,335,JH
KARNATAKA,2012,Others (Please Specify),39,985,1467,943,353,3787,23,520,350,189,66,1148,4935,KA
KARNATAKA,2012,House Wife,0,0,0,0,0,0,0,717,601,373,159,1850,1850,KA
KARNATAKA,2012,Service (Government),0,24,68,78,4,174,0,14,13,2,0,29,203,KA
KARNATAKA,2012,Service (Private),0,392,338,233,37,1000,4,126,82,40,9,261,1261,KA
KARNATAKA,2012,Public Sector Undertaking,0,71,98,70,15,254,0,19,47,21,1,88,342,KA
KARNATAKA,2012,Student,33,257,6,0,0,296,51,198,9,5,1,264,560,KA
KARNATAKA,2012,Unemployed,0,166,299,134,34,633,0,47,16,13,6,82,715,KA
KARNATAKA,2012,Self-employed (Business activity),0,107,243,189,69,608,0,18,9,7,0,34,642,KA
KARNATAKA,2012,Professional Activity,6,67,83,83,29,268,0,14,12,5,2,33,301,KA
KARNATAKA,2012,Farming/Agriculture Activity,0,289,554,482,191,1516,0,113,124,100,22,359,1875,KA
KARNATAKA,2012,Retired Person,0,0,1,28,31,60,0,0,0,1,8,9,69,KA
KARNATAKA,2012,Total,78,2358,3157,2240,763,8596,78,1786,1263,756,274,4157,12753,KA
KARNATAKA,2012,Total Salaried,0,487,504,381,56,1428,4,159,142,63,10,378,1806,KA
KARNATAKA,2012,Total Self-employed,32,1178,1851,1409,549,5019,7,464,330,191,48,1040,6059,KA
KERALA,2012,Others (Please Specify),0,534,1050,1128,695,3407,3,70,88,96,88,345,3752,KL
KERALA,2012,House Wife,0,0,0,0,0,0,0,250,323,372,249,1194,1194,KL
KERALA,2012,Service (Government),0,4,21,27,0,52,0,1,4,4,0,9,61,KL
KERALA,2012,Service (Private),0,92,190,163,38,483,0,36,25,19,0,80,563,KL
KERALA,2012,Public Sector Undertaking,0,9,33,31,2,75,0,1,2,3,1,7,82,KL
KERALA,2012,Student,31,59,0,0,0,90,27,146,0,0,0,173,263,KL
KERALA,2012,Unemployed,0,80,194,214,123,611,0,39,51,27,25,142,753,KL
KERALA,2012,Self-employed (Business activity),0,52,145,203,68,468,0,0,5,4,2,11,479,KL
KERALA,2012,Professional Activity,0,20,50,81,11,162,0,6,2,2,0,10,172,KL
KERALA,2012,Farming/Agriculture Activity,0,71,293,360,258,982,0,25,30,26,18,99,1081,KL
KERALA,2012,Retired Person,0,0,0,28,51,79,0,0,0,3,8,11,90,KL
KERALA,2012,Total,31,921,1976,2235,1246,6409,30,574,530,556,391,2081,8490,KL
KERALA,2012,Total Salaried,0,105,244,221,40,610,0,38,31,26,1,96,706,KL
KERALA,2012,Total Self-employed,0,507,1110,1159,697,3473,1,80,90,79,73,323,3796,KL
LAKSHADWEEP,2012,Others (Please Specify),0,0,1,0,0,1,0,0,0,0,0,0,1,LD
LAKSHADWEEP,2012,House Wife,0,0,0,0,0,0,0,0,0,0,0,0,0,LD
LAKSHADWEEP,2012,Service (Government),0,0,0,0,0,0,0,0,0,0,0,0,0,LD
LAKSHADWEEP,2012,Service (Private),0,0,0,0,0,0,0,0,0,0,0,0,0,LD
LAKSHADWEEP,2012,Public Sector Undertaking,0,0,0,0,0,0,0,0,0,0,0,0,0,LD
LAKSHADWEEP,2012,Student,0,0,0,0,0,0,0,0,0,0,0,0,0,LD
LAKSHADWEEP,2012,Unemployed,0,0,0,0,0,0,0,0,0,0,0,0,0,LD
LAKSHADWEEP,2012,Self-employed (Business activity),0,0,0,0,0,0,0,0,0,0,0,0,0,LD
LAKSHADWEEP,2012,Professional Activity,0,0,0,0,0,0,0,0,0,0,0,0,0,LD
LAKSHADWEEP,2012,Farming/Agriculture Activity,0,0,0,0,0,0,0,0,0,0,0,0,0,LD
LAKSHADWEEP,2012,Retired Person,0,0,0,0,0,0,0,0,0,0,0,0,0,LD
LAKSHADWEEP,2012,Total,0,0,1,0,0,1,0,0,0,0,0,0,1,LD
LAKSHADWEEP,2012,Total Salaried,0,0,0,0,0,0,0,0,0,0,0,0,0,LD
LAKSHADWEEP,2012,Total Self-employed,0,0,0,0,0,0,0,0,0,0,0,0,0,LD
MADHYA PRADESH,2012,Others (Please Specify),51,766,795,493,254,2359,48,226,131,77,52,534,2893,MP
MADHYA PRADESH,2012,House Wife,0,0,0,0,0,0,4,1463,824,314,135,2740,2740,MP
MADHYA PRADESH,2012,Service (Government),0,21,42,18,2,83,1,5,11,0,0,17,100,MP
MADHYA PRADESH,2012,Service (Private),2,236,251,103,19,611,0,38,35,14,0,87,698,MP
MADHYA PRADESH,2012,Public Sector Undertaking,0,48,62,27,13,150,0,2,12,8,2,24,174,MP
MADHYA PRADESH,2012,Student,85,235,11,0,0,331,74,187,2,1,0,264,595,MP
MADHYA PRADESH,2012,Unemployed,6,177,118,42,8,351,4,23,31,29,4,91,442,MP
MADHYA PRADESH,2012,Self-employed (Business activity),0,114,151,121,36,422,0,22,12,11,2,47,469,MP
MADHYA PRADESH,2012,Professional Activity,0,129,145,90,38,402,0,24,17,14,6,61,463,MP
MADHYA PRADESH,2012,Farming/Agriculture Activity,0,270,413,253,102,1038,3,70,39,18,4,134,1172,MP
MADHYA PRADESH,2012,Retired Person,0,0,0,1,26,27,0,0,0,0,2,2,29,MP
MADHYA PRADESH,2012,Total,144,1996,1988,1148,498,5774,134,2060,1114,486,207,4001,9775,MP
MADHYA PRADESH,2012,Total Salaried,2,305,355,148,34,844,1,45,58,22,2,128,972,MP
MADHYA PRADESH,2012,Total Self-employed,34,991,1222,764,338,3349,36,243,159,107,42,587,3936,MP
MAHARASHTRA,2012,Others (Please Specify),9,853,1073,699,320,2954,12,152,79,47,20,310,3264,MH
MAHARASHTRA,2012,House Wife,0,0,0,0,0,0,3,1637,1010,438,262,3350,3350,MH
MAHARASHTRA,2012,Service (Government),0,32,70,58,1,161,0,19,8,1,0,28,189,MH
MAHARASHTRA,2012,Service (Private),0,721,826,477,77,2101,0,108,41,12,2,163,2264,MH
MAHARASHTRA,2012,Public Sector Undertaking,0,60,77,66,6,209,0,8,4,1,0,13,222,MH
MAHARASHTRA,2012,Student,64,376,9,0,0,449,68,401,3,0,0,472,921,MH
MAHARASHTRA,2012,Unemployed,0,370,296,143,23,832,0,91,27,14,0,132,964,MH
MAHARASHTRA,2012,Self-employed (Business activity),0,164,224,136,45,569,0,2,4,1,1,8,577,MH
MAHARASHTRA,2012,Professional Activity,0,116,156,98,33,403,0,13,6,5,2,26,429,MH
MAHARASHTRA,2012,Farming/Agriculture Activity,0,804,1267,980,432,3483,0,100,131,55,17,303,3786,MH
MAHARASHTRA,2012,Retired Person,0,0,0,22,121,143,0,0,0,0,3,3,146,MH
MAHARASHTRA,2012,Total,73,3496,3998,2679,1058,11304,83,2531,1313,574,307,4808,16112,MH
MAHARASHTRA,2012,Total Salaried,0,813,973,601,84,2471,0,135,53,14,2,204,2675,MH
MAHARASHTRA,2012,Total Self-employed,6,1691,2405,1731,755,6588,9,226,203,96,32,566,7154,MH
MANIPUR,2012,Others (Please Specify),0,5,5,0,0,10,0,3,0,0,0,3,13,MN
MANIPUR,2012,House Wife,0,0,0,0,0,0,0,3,4,1,1,9,9,MN
MANIPUR,2012,Service (Government),0,1,4,0,0,5,0,0,0,0,0,0,5,MN
MANIPUR,2012,Service (Private),0,0,0,0,0,0,0,0,0,0,0,0,0,MN
MANIPUR,2012,Public Sector Undertaking,0,0,0,0,0,0,0,0,0,0,0,0,0,MN
MANIPUR,2012,Student,0,8,0,0,0,8,1,5,0,0,0,6,14,MN
MANIPUR,2012,Unemployed,0,0,0,0,0,0,0,0,0,0,0,0,0,MN
MANIPUR,2012,Self-employed (Business activity),0,0,0,0,0,0,0,0,0,0,0,0,0,MN
MANIPUR,2012,Professional Activity,0,0,0,0,0,0,0,0,0,0,0,0,0,MN
MANIPUR,2012,Farming/Agriculture Activity,0,0,0,0,0,0,0,0,0,0,0,0,0,MN
MANIPUR,2012,Retired Person,0,0,0,0,0,0,0,0,0,0,0,0,0,MN
MANIPUR,2012,Total,0,14,9,0,0,23,1,11,4,1,1,18,41,MN
MANIPUR,2012,Total Salaried,0,1,4,0,0,5,0,0,0,0,0,0,5,MN
MANIPUR,2012,Total Self-employed,0,0,0,0,0,0,0,0,0,0,0,0,0,MN
MEGHALAYA,2012,Others (Please Specify),0,3,11,4,1,19,1,5,0,0,0,6,25,ML
MEGHALAYA,2012,House Wife,0,0,0,0,0,0,0,6,6,2,0,14,14,ML
MEGHALAYA,2012,Service (Government),0,2,1,1,0,4,0,0,0,0,0,0,4,ML
MEGHALAYA,2012,Service (Private),1,2,1,1,0,5,0,0,0,0,0,0,5,ML
MEGHALAYA,2012,Public Sector Undertaking,0,0,1,0,0,1,0,0,0,0,0,0,1,ML
MEGHALAYA,2012,Student,2,12,0,0,0,14,1,10,0,0,0,11,25,ML
MEGHALAYA,2012,Unemployed,0,8,5,4,0,17,0,5,1,0,0,6,23,ML
MEGHALAYA,2012,Self-employed (Business activity),0,9,6,3,0,18,0,0,0,0,0,0,18,ML
MEGHALAYA,2012,Professional Activity,0,1,2,0,0,3,0,0,0,0,0,0,3,ML
MEGHALAYA,2012,Farming/Agriculture Activity,0,3,3,3,0,9,0,1,0,0,0,1,10,ML
MEGHALAYA,2012,Retired Person,0,0,0,0,0,0,0,0,0,0,0,0,0,ML
MEGHALAYA,2012,Total,3,40,30,16,1,90,2,27,7,2,0,38,128,ML
MEGHALAYA,2012,Total Salaried,1,4,3,2,0,10,0,0,0,0,0,0,10,ML
MEGHALAYA,2012,Total Self-employed,0,15,19,10,0,44,0,3,0,0,0,3,47,ML
MIZORAM,2012,Others (Please Specify),1,16,3,0,0,20,0,0,0,3,1,4,24,MZ
MIZORAM,2012,House Wife,0,0,0,0,0,0,0,0,1,0,0,1,1,MZ
MIZORAM,2012,Service (Government),0,0,1,1,0,2,0,0,0,0,0,0,2,MZ
MIZORAM,2012,Service (Private),3,0,13,0,0,16,0,4,0,0,0,4,20,MZ
MIZORAM,2012,Public Sector Undertaking,0,0,0,0,0,0,0,0,0,0,0,0,0,MZ
MIZORAM,2012,Student,0,1,5,0,0,6,0,1,0,0,0,1,7,MZ
MIZORAM,2012,Unemployed,2,28,17,10,6,63,3,0,0,0,0,3,66,MZ
MIZORAM,2012,Self-employed (Business activity),1,22,13,3,0,39,0,0,0,0,0,0,39,MZ
MIZORAM,2012,Professional Activity,0,0,0,0,0,0,0,0,0,0,0,0,0,MZ
MIZORAM,2012,Farming/Agriculture Activity,0,3,5,1,0,9,0,0,0,1,0,1,10,MZ
MIZORAM,2012,Retired Person,0,0,0,0,2,2,0,2,0,0,0,2,4,MZ
MIZORAM,2012,Total,7,70,57,15,8,157,3,7,1,4,1,16,173,MZ
MIZORAM,2012,Total Salaried,3,0,14,1,0,18,0,4,0,0,0,4,22,MZ
MIZORAM,2012,Total Self-employed,1,33,18,4,0,56,0,0,0,3,0,3,59,MZ
NAGALAND,2012,Others (Please Specify),0,1,0,0,0,1,0,0,0,0,0,0,1,NG
NAGALAND,2012,House Wife,0,0,0,0,0,0,0,2,1,0,0,3,3,NG
NAGALAND,2012,Service (Government),0,3,2,1,0,6,0,0,0,0,0,0,6,NG
NAGALAND,2012,Service (Private),0,0,0,0,0,0,0,0,0,0,0,0,0,NG
NAGALAND,2012,Public Sector Undertaking,0,0,0,0,0,0,0,0,0,0,0,0,0,NG
NAGALAND,2012,Student,0,2,0,0,0,2,1,1,0,0,0,2,4,NG
NAGALAND,2012,Unemployed,0,0,1,0,0,1,0,0,0,0,0,0,1,NG
NAGALAND,2012,Self-employed (Business activity),0,1,1,1,0,3,0,0,0,0,0,0,3,NG
NAGALAND,2012,Professional Activity,0,0,2,1,0,3,0,0,0,0,0,0,3,NG
NAGALAND,2012,Farming/Agriculture Activity,0,4,2,2,0,8,0,1,0,0,0,1,9,NG
NAGALAND,2012,Retired Person,0,0,0,0,0,0,0,0,0,0,0,0,0,NG
NAGALAND,2012,Total,0,11,8,5,0,24,1,4,1,0,0,6,30,NG
NAGALAND,2012,Total Salaried,0,3,2,1,0,6,0,0,0,0,0,0,6,NG
NAGALAND,2012,Total Self-employed,0,6,5,4,0,15,0,1,0,0,0,1,16,NG
ODISHA,2012,Others (Please Specify),95,299,255,261,173,1083,72,211,159,121,71,634,1717,OD
ODISHA,2012,House Wife,0,0,0,0,0,0,0,363,362,124,21,870,870,OD
ODISHA,2012,Service (Government),0,12,11,4,1,28,1,8,18,6,3,36,64,OD
ODISHA,2012,Service (Private),5,109,141,84,7,346,2,43,69,22,5,141,487,OD
ODISHA,2012,Public Sector Undertaking,0,34,34,21,0,89,8,7,13,10,0,38,127,OD
ODISHA,2012,Student,28,165,24,16,0,233,49,115,26,0,0,190,423,OD
ODISHA,2012,Unemployed,10,158,186,68,2,424,7,49,50,22,2,130,554,OD
ODISHA,2012,Self-employed (Business activity),6,63,166,121,21,377,1,17,9,11,1,39,416,OD
ODISHA,2012,Professional Activity,0,8,97,35,10,150,0,2,9,2,0,13,163,OD
ODISHA,2012,Farming/Agriculture Activity,0,14,45,53,9,121,1,10,6,8,0,25,146,OD
ODISHA,2012,Retired Person,0,5,5,16,19,45,2,4,0,3,6,15,60,OD
ODISHA,2012,Total,144,867,964,679,242,2896,143,829,721,329,109,2131,5027,OD
ODISHA,2012,Total Salaried,5,155,186,109,8,463,11,58,100,38,8,215,678,OD
ODISHA,2012,Total Self-employed,40,217,447,351,131,1186,30,151,108,90,32,411,1597,OD
PUDUCHERRY,2012,Others (Please Specify),1,22,52,49,7,131,0,1,5,1,0,7,138,PY
PUDUCHERRY,2012,House Wife,0,0,0,0,0,0,0,32,42,17,12,103,103,PY
PUDUCHERRY,2012,Service (Government),0,5,5,5,1,16,0,2,1,1,0,4,20,PY
PUDUCHERRY,2012,Service (Private),0,4,5,2,0,11,0,9,0,0,0,9,20,PY
PUDUCHERRY,2012,Public Sector Undertaking,0,0,0,0,0,0,0,2,0,0,0,2,2,PY
PUDUCHERRY,2012,Student,0,23,0,0,0,23,4,17,1,0,0,22,45,PY
PUDUCHERRY,2012,Unemployed,0,14,11,13,26,64,0,10,2,1,6,19,83,PY
PUDUCHERRY,2012,Self-employed (Business activity),0,1,7,5,3,16,0,0,2,0,0,2,18,PY
PUDUCHERRY,2012,Professional Activity,0,23,47,29,6,105,0,0,1,0,0,1,106,PY
PUDUCHERRY,2012,Farming/Agriculture Activity,0,0,0,0,0,0,0,0,0,0,0,0,0,PY
PUDUCHERRY,2012,Retired Person,0,0,0,0,6,6,0,0,0,0,0,0,6,PY
PUDUCHERRY,2012,Total,1,92,127,103,49,372,4,73,54,20,18,169,541,PY
PUDUCHERRY,2012,Total Salaried,0,9,10,7,1,27,0,13,1,1,0,15,42,PY
PUDUCHERRY,2012,Total Self-employed,0,46,106,82,16,250,0,0,8,1,0,9,259,PY
PUNJAB,2012,Others (Please Specify),2,105,132,64,27,330,0,13,7,1,0,21,351,PN
PUNJAB,2012,House Wife,0,0,0,0,0,0,1,71,84,15,2,173,173,PN
PUNJAB,2012,Service (Government),0,6,5,2,0,13,0,1,0,0,0,1,14,PN
PUNJAB,2012,Service (Private),0,68,69,26,6,169,0,2,8,2,0,12,181,PN
PUNJAB,2012,Public Sector Undertaking,0,6,6,1,0,13,0,4,0,0,0,4,17,PN
PUNJAB,2012,Student,5,25,0,0,0,30,1,26,0,0,0,27,57,PN
PUNJAB,2012,Unemployed,0,50,19,10,4,83,0,4,1,2,0,7,90,PN
PUNJAB,2012,Self-employed (Business activity),0,10,18,8,3,39,0,0,0,0,0,0,39,PN
PUNJAB,2012,Professional Activity,0,6,15,4,0,25,0,0,0,0,0,0,25,PN
PUNJAB,2012,Farming/Agriculture Activity,0,23,34,8,10,75,0,0,0,0,0,0,75,PN
PUNJAB,2012,Retired Person,0,0,1,2,4,7,0,0,0,1,0,1,8,PN
PUNJAB,2012,Total,7,299,299,125,54,784,2,121,100,21,2,246,1030,PN
PUNJAB,2012,Total Salaried,0,80,80,29,6,195,0,7,8,2,0,17,212,PN
PUNJAB,2012,Total Self-employed,0,119,163,67,33,382,0,9,3,1,0,13,395,PN
RAJASTHAN,2012,Others (Please Specify),53,599,720,515,97,1984,23,203,160,71,20,477,2461,RJ
RAJASTHAN,2012,House Wife,0,0,0,0,0,0,1,413,337,106,37,894,894,RJ
RAJASTHAN,2012,Service (Government),0,12,19,16,1,48,0,2,3,0,0,5,53,RJ
RAJASTHAN,2012,Service (Private),0,153,148,62,7,370,0,12,12,2,2,28,398,RJ
RAJASTHAN,2012,Public Sector Undertaking,0,7,8,20,6,41,0,1,2,0,0,3,44,RJ
RAJASTHAN,2012,Student,15,119,4,0,0,138,14,84,3,0,1,102,240,RJ
RAJASTHAN,2012,Unemployed,0,56,47,21,8,132,1,9,27,6,0,43,175,RJ
RAJASTHAN,2012,Self-employed (Business activity),0,49,78,31,7,165,0,1,11,1,0,13,178,RJ
RAJASTHAN,2012,Professional Activity,0,23,47,26,0,96,0,0,0,1,0,1,97,RJ
RAJASTHAN,2012,Farming/Agriculture Activity,0,68,88,66,20,242,1,16,7,4,0,28,270,RJ
RAJASTHAN,2012,Retired Person,0,0,1,2,8,11,0,0,0,0,0,0,11,RJ
RAJASTHAN,2012,Total,68,1086,1160,759,154,3227,40,741,562,191,60,1594,4821,RJ
RAJASTHAN,2012,Total Salaried,0,172,175,98,14,459,0,15,17,2,2,36,495,RJ
RAJASTHAN,2012,Total Self-employed,10,372,500,265,54,1201,5,53,41,18,3,120,1321,RJ
SIKKIM,2012,Others (Please Specify),0,2,2,0,5,9,0,2,5,3,1,11,20,SK
SIKKIM,2012,House Wife,0,0,0,0,0,0,0,9,7,4,2,22,22,SK
SIKKIM,2012,Service (Government),0,7,7,3,0,17,0,5,0,1,0,6,23,SK
SIKKIM,2012,Service (Private),0,5,5,4,0,14,0,4,3,1,0,8,22,SK
SIKKIM,2012,Public Sector Undertaking,0,2,2,4,0,8,0,0,2,0,0,2,10,SK
SIKKIM,2012,Student,5,2,0,0,0,7,6,4,3,0,0,13,20,SK
SIKKIM,2012,Unemployed,0,5,0,0,0,5,0,6,8,0,0,14,19,SK
SIKKIM,2012,Self-employed (Business activity),0,5,4,3,3,15,0,0,0,0,0,0,15,SK
SIKKIM,2012,Professional Activity,0,2,2,5,2,11,0,0,0,0,0,0,11,SK
SIKKIM,2012,Farming/Agriculture Activity,0,5,4,1,0,10,0,5,2,0,2,9,19,SK
SIKKIM,2012,Retired Person,0,0,0,0,0,0,0,0,0,0,0,0,0,SK
SIKKIM,2012,Total,5,35,26,20,10,96,6,35,30,9,5,85,181,SK
SIKKIM,2012,Total Salaried,0,14,14,11,0,39,0,9,5,2,0,16,55,SK
SIKKIM,2012,Total Self-employed,0,14,12,9,10,45,0,7,7,3,3,20,65,SK
TAMIL NADU,2012,Others (Please Specify),43,1619,2459,1245,843,6209,80,775,372,355,312,1894,8103,TN
TAMIL NADU,2012,House Wife,0,0,0,0,0,0,3,1097,1031,575,205,2911,2911,TN
TAMIL NADU,2012,Service (Government),0,39,101,93,4,237,0,17,22,8,0,47,284,TN
TAMIL NADU,2012,Service (Private),0,202,381,244,34,861,0,85,72,25,4,186,1047,TN
TAMIL NADU,2012,Public Sector Undertaking,0,41,76,67,7,191,0,22,27,17,1,67,258,TN
TAMIL NADU,2012,Student,101,274,12,0,0,387,95,294,19,0,0,408,795,TN
TAMIL NADU,2012,Unemployed,5,316,425,594,177,1517,4,175,141,83,18,421,1938,TN
TAMIL NADU,2012,Self-employed (Business activity),0,164,262,226,78,730,0,20,29,19,3,71,801,TN
TAMIL NADU,2012,Professional Activity,0,40,40,46,19,145,0,31,32,10,2,75,220,TN
TAMIL NADU,2012,Farming/Agriculture Activity,0,68,137,123,81,409,0,31,32,22,5,90,499,TN
TAMIL NADU,2012,Retired Person,0,0,3,13,46,62,0,0,0,0,9,9,71,TN
TAMIL NADU,2012,Total,149,2763,3896,2651,1289,10748,182,2547,1777,1114,559,6179,16927,TN
TAMIL NADU,2012,Total Salaried,0,282,558,404,45,1289,0,124,121,50,5,300,1589,TN
TAMIL NADU,2012,Total Self-employed,10,898,1330,1033,459,3730,23,323,267,159,50,822,4552,TN
TRIPURA,2012,Others (Please Specify),9,112,177,75,30,403,11,44,47,13,7,122,525,TR
TRIPURA,2012,House Wife,0,0,0,0,0,0,0,44,36,24,24,128,128,TR
TRIPURA,2012,Service (Government),0,1,0,1,0,2,0,0,0,0,0,0,2,TR
TRIPURA,2012,Service (Private),0,3,3,0,0,6,0,0,0,0,0,0,6,TR
TRIPURA,2012,Public Sector Undertaking,0,0,0,0,0,0,0,0,0,0,0,0,0,TR
TRIPURA,2012,Student,7,38,0,0,0,45,4,27,0,0,0,31,76,TR
TRIPURA,2012,Unemployed,0,9,10,6,0,25,0,1,2,0,0,3,28,TR
TRIPURA,2012,Self-employed (Business activity),0,2,15,23,15,55,0,0,0,0,0,0,55,TR
TRIPURA,2012,Professional Activity,0,0,0,2,4,6,0,0,0,0,0,0,6,TR
TRIPURA,2012,Farming/Agriculture Activity,0,5,6,5,2,18,0,0,0,0,0,0,18,TR
TRIPURA,2012,Retired Person,0,0,0,0,0,0,0,0,0,0,0,0,0,TR
TRIPURA,2012,Total,16,170,211,112,51,560,15,116,85,37,31,284,844,TR
TRIPURA,2012,Total Salaried,0,4,3,1,0,8,0,0,0,0,0,0,8,TR
TRIPURA,2012,Total Self-employed,5,56,54,59,40,214,2,15,5,1,0,23,237,TR
UTTAR PRADESH,2012,Others (Please Specify),6,227,213,217,89,752,12,162,56,63,22,315,1067,UP
UTTAR PRADESH,2012,House Wife,0,0,0,0,0,0,7,546,393,98,33,1077,1077,UP
UTTAR PRADESH,2012,Service (Government),0,24,23,15,0,62,4,10,12,1,0,27,89,UP
UTTAR PRADESH,2012,Service (Private),1,94,142,73,15,325,14,93,24,14,0,145,470,UP
UTTAR PRADESH,2012,Public Sector Undertaking,0,12,8,11,0,31,0,6,10,9,0,25,56,UP
UTTAR PRADESH,2012,Student,20,122,11,1,0,154,15,104,31,0,1,151,305,UP
UTTAR PRADESH,2012,Unemployed,2,98,80,26,3,209,0,21,15,1,0,37,246,UP
UTTAR PRADESH,2012,Self-employed (Business activity),0,85,80,32,13,210,0,6,6,5,0,17,227,UP
UTTAR PRADESH,2012,Professional Activity,0,22,53,28,22,125,0,5,0,0,0,5,130,UP
UTTAR PRADESH,2012,Farming/Agriculture Activity,2,161,230,170,56,619,2,36,44,27,17,126,745,UP
UTTAR PRADESH,2012,Retired Person,0,0,2,1,5,8,0,0,0,0,2,2,10,UP
UTTAR PRADESH,2012,Total,31,845,842,574,203,2495,54,989,591,218,75,1927,4422,UP
UTTAR PRADESH,2012,Total Salaried,1,130,173,99,15,418,18,109,46,24,0,197,615,UP
UTTAR PRADESH,2012,Total Self-employed,5,364,458,305,104,1236,6,136,77,71,23,313,1549,UP
UTTARAKHAND,2012,Others (Please Specify),6,33,51,24,11,125,7,45,27,10,4,93,218,UK
UTTARAKHAND,2012,House Wife,0,0,0,0,0,0,0,43,15,2,3,63,63,UK
UTTARAKHAND,2012,Service (Government),0,1,6,0,0,7,0,0,0,0,0,0,7,UK
UTTARAKHAND,2012,Service (Private),0,11,21,13,0,45,0,1,1,0,0,2,47,UK
UTTARAKHAND,2012,Public Sector Undertaking,0,0,5,2,0,7,1,0,0,0,0,1,8,UK
UTTARAKHAND,2012,Student,1,8,2,0,0,11,1,6,2,0,0,9,20,UK
UTTARAKHAND,2012,Unemployed,0,10,11,0,0,21,0,4,1,0,0,5,26,UK
UTTARAKHAND,2012,Self-employed (Business activity),0,7,5,6,2,20,0,0,0,0,0,0,20,UK
UTTARAKHAND,2012,Professional Activity,0,0,0,1,0,1,0,0,0,0,0,0,1,UK
UTTARAKHAND,2012,Farming/Agriculture Activity,0,3,5,1,3,12,0,1,1,0,0,2,14,UK
UTTARAKHAND,2012,Retired Person,0,0,0,0,0,0,0,0,0,0,0,0,0,UK
UTTARAKHAND,2012,Total,7,73,106,47,16,249,9,100,47,12,7,175,424,UK
UTTARAKHAND,2012,Total Salaried,0,12,32,15,0,59,1,1,1,0,0,3,62,UK
UTTARAKHAND,2012,Total Self-employed,1,16,28,13,7,65,3,8,5,2,0,18,83,UK
WEST BENGAL,2012,Others (Please Specify),0,0,0,0,0,0,0,0,0,0,0,0,0,WB
WEST BENGAL,2012,House Wife,0,0,0,0,0,0,0,0,0,0,0,0,0,WB
WEST BENGAL,2012,Service (Government),0,0,0,0,0,0,0,0,0,0,0,0,0,WB
WEST BENGAL,2012,Service (Private),0,0,0,0,0,0,0,0,0,0,0,0,0,WB
WEST BENGAL,2012,Public Sector Undertaking,0,0,0,0,0,0,0,0,0,0,0,0,0,WB
WEST BENGAL,2012,Student,0,0,0,0,0,0,0,0,0,0,0,0,0,WB
WEST BENGAL,2012,Unemployed,0,0,0,0,0,0,0,0,0,0,0,0,0,WB
WEST BENGAL,2012,Self-employed (Business activity),0,0,0,0,0,0,0,0,0,0,0,0,0,WB
WEST BENGAL,2012,Professional Activity,0,0,0,0,0,0,0,0,0,0,0,0,0,WB
WEST BENGAL,2012,Farming/Agriculture Activity,0,0,0,0,0,0,0,0,0,0,0,0,0,WB
WEST BENGAL,2012,Retired Person,0,0,0,0,0,0,0,0,0,0,0,0,0,WB
WEST BENGAL,2012,Total,0,0,0,0,0,0,0,0,0,0,0,0,0,WB
WEST BENGAL,2012,Total Salaried,0,0,0,0,0,0,0,0,0,0,0,0,0,WB
WEST BENGAL,2012,Total Self-employed,0,0,0,0,0,0,0,0,0,0,0,0,0,WB
A & N ISLANDS,2013,Others (Please Specify),0,0,0,0,0,0,0,0,0,0,0,0,0,AN
A & N ISLANDS,2013,House Wife,0,0,0,0,0,0,0,10,7,3,1,21,21,AN
A & N ISLANDS,2013,Service (Government),0,2,8,9,0,19,0,0,1,1,0,2,21,AN
A & N ISLANDS,2013,Service (Private),0,25,18,16,5,64,0,0,1,0,0,1,65,AN
A & N ISLANDS,2013,Public Sector Undertaking,0,0,0,0,1,1,0,0,0,0,0,0,1,AN
A & N ISLANDS,2013,Student,4,8,0,0,0,12,2,8,0,0,0,10,22,AN
A & N ISLANDS,2013,Unemployed,0,0,2,0,1,3,0,4,2,0,0,6,9,AN
A & N ISLANDS,2013,Self-employed (Business activity),0,0,1,2,0,3,0,0,0,0,0,0,3,AN
A & N ISLANDS,2013,Professional Activity,0,0,0,0,0,0,0,0,0,0,0,0,0,AN
A & N ISLANDS,2013,Farming/Agriculture Activity,0,0,0,1,4,5,0,0,0,0,0,0,5,AN
A & N ISLANDS,2013,Retired Person,0,0,0,0,4,4,0,0,0,0,0,0,4,AN
A & N ISLANDS,2013,Total,4,35,29,28,15,111,2,22,11,4,1,40,151,AN
A & N ISLANDS,2013,Total Salaried,0,27,26,25,6,84,0,0,2,1,0,3,87,AN
A & N ISLANDS,2013,Total Self-employed,0,0,1,3,4,8,0,0,0,0,0,0,8,AN
ANDHRA PRADESH,2013,Others (Please Specify),23,1176,1545,1133,493,4370,33,502,495,268,174,1472,5842,AP
ANDHRA PRADESH,2013,House Wife,0,0,0,0,0,0,1,803,600,347,161,1912,1912,AP
ANDHRA PRADESH,2013,Service (Government),0,41,56,49,3,149,0,11,8,1,0,20,169,AP
ANDHRA PRADESH,2013,Service (Private),0,384,551,280,84,1299,3,156,88,29,19,295,1594,AP
ANDHRA PRADESH,2013,Public Sector Undertaking,0,67,108,68,20,263,0,11,36,3,0,50,313,AP
ANDHRA PRADESH,2013,Student,45,324,34,0,0,403,43,257,16,0,0,316,719,AP
ANDHRA PRADESH,2013,Unemployed,0,170,226,125,42,563,0,33,39,3,1,76,639,AP
ANDHRA PRADESH,2013,Self-employed (Business activity),0,190,305,188,41,724,0,5,34,2,0,41,765,AP
ANDHRA PRADESH,2013,Professional Activity,0,150,222,103,22,497,0,7,9,5,7,28,525,AP
ANDHRA PRADESH,2013,Farming/Agriculture Activity,0,345,598,467,144,1554,1,138,175,94,52,460,2014,AP
ANDHRA PRADESH,2013,Retired Person,0,0,3,26,51,80,0,0,0,22,13,35,115,AP
ANDHRA PRADESH,2013,Total,68,2847,3648,2439,900,9902,81,1923,1500,774,427,4705,14607,AP
ANDHRA PRADESH,2013,Total Salaried,0,492,715,397,107,1711,3,178,132,33,19,365,2076,AP
ANDHRA PRADESH,2013,Total Self-employed,5,1385,2090,1473,518,5471,14,430,423,224,148,1239,6710,AP
ARUNACHAL PRADESH,2013,Others (Please Specify),3,14,19,1,2,39,2,5,4,1,0,12,51,AR
ARUNACHAL PRADESH,2013,House Wife,0,0,0,0,0,0,0,9,8,2,1,20,20,AR
ARUNACHAL PRADESH,2013,Service (Government),0,8,14,6,0,28,0,2,1,0,0,3,31,AR
ARUNACHAL PRADESH,2013,Service (Private),0,7,3,6,0,16,0,0,1,0,0,1,17,AR
ARUNACHAL PRADESH,2013,Public Sector Undertaking,0,0,1,1,0,2,0,0,0,0,0,0,2,AR
ARUNACHAL PRADESH,2013,Student,3,13,1,0,0,17,2,8,1,0,0,11,28,AR
ARUNACHAL PRADESH,2013,Unemployed,0,6,16,4,1,27,0,4,2,0,0,6,33,AR
ARUNACHAL PRADESH,2013,Self-employed (Business activity),1,2,3,2,1,9,0,0,0,0,0,0,9,AR
ARUNACHAL PRADESH,2013,Professional Activity,0,1,0,0,0,1,0,0,0,0,0,0,1,AR
ARUNACHAL PRADESH,2013,Farming/Agriculture Activity,0,5,8,13,6,32,0,3,2,0,0,5,37,AR
ARUNACHAL PRADESH,2013,Retired Person,0,0,0,0,0,0,0,0,0,0,0,0,0,AR
ARUNACHAL PRADESH,2013,Total,7,56,65,33,10,171,4,31,19,3,1,58,229,AR
ARUNACHAL PRADESH,2013,Total Salaried,0,15,18,13,0,46,0,2,2,0,0,4,50,AR
ARUNACHAL PRADESH,2013,Total Self-employed,4,13,13,15,7,52,1,4,2,0,0,7,59,AR
ASSAM,2013,Others (Please Specify),6,313,530,187,13,1049,6,81,68,37,4,196,1245,AS
ASSAM,2013,House Wife,0,0,0,0,0,0,0,155,284,129,9,577,577,AS
ASSAM,2013,Service (Government),0,0,6,1,0,7,0,3,1,0,0,4,11,AS
ASSAM,2013,Service (Private),0,9,33,11,0,53,0,5,8,1,0,14,67,AS
ASSAM,2013,Public Sector Undertaking,0,53,93,61,0,207,0,2,7,0,0,9,216,AS
ASSAM,2013,Student,5,234,0,0,0,239,1,124,0,0,0,125,364,AS
ASSAM,2013,Unemployed,0,4,59,133,3,199,0,5,3,4,0,12,211,AS
ASSAM,2013,Self-employed (Business activity),0,98,177,95,4,374,0,10,11,3,0,24,398,AS
ASSAM,2013,Professional Activity,0,38,68,39,3,148,0,3,2,2,0,7,155,AS
ASSAM,2013,Farming/Agriculture Activity,0,74,124,77,3,278,0,11,9,7,0,27,305,AS
ASSAM,2013,Retired Person,0,0,0,0,4,4,0,0,0,0,0,0,4,AS
ASSAM,2013,Total,11,823,1090,604,30,2558,7,399,393,183,13,995,3553,AS
ASSAM,2013,Total Salaried,0,62,132,73,0,267,0,10,16,1,0,27,294,AS
ASSAM,2013,Total Self-employed,1,491,818,354,20,1684,1,85,63,32,0,181,1865,AS
BIHAR,2013,Others (Please Specify),8,72,116,79,27,302,35,78,43,10,5,171,473,BR
BIHAR,2013,House Wife,0,0,0,0,0,0,0,55,93,18,2,168,168,BR
BIHAR,2013,Service (Government),0,3,4,0,0,7,0,4,3,0,0,7,14,BR
BIHAR,2013,Service (Private),0,18,20,14,0,52,0,11,8,3,0,22,74,BR
BIHAR,2013,Public Sector Undertaking,0,0,0,0,0,0,0,0,0,0,0,0,0,BR
BIHAR,2013,Student,18,22,6,0,0,46,12,20,4,0,0,36,82,BR
BIHAR,2013,Unemployed,0,30,43,14,7,94,0,10,5,0,0,15,109,BR
BIHAR,2013,Self-employed (Business activity),0,1,1,2,0,4,0,0,0,0,0,0,4,BR
BIHAR,2013,Professional Activity,0,1,3,1,1,6,0,0,0,0,0,0,6,BR
BIHAR,2013,Farming/Agriculture Activity,0,29,60,16,14,119,0,3,4,1,0,8,127,BR
BIHAR,2013,Retired Person,0,0,0,0,0,0,0,0,0,0,0,0,0,BR
BIHAR,2013,Total,26,176,253,126,49,630,47,181,160,32,7,427,1057,BR
BIHAR,2013,Total Salaried,0,21,24,14,0,59,0,15,11,3,0,29,88,BR
BIHAR,2013,Total Self-employed,5,51,99,45,19,219,17,42,19,3,1,82,301,BR
CHANDIGARH,2013,Others (Please Specify),0,7,4,2,0,13,0,2,0,0,0,2,15,CH
CHANDIGARH,2013,House Wife,0,0,0,0,0,0,0,10,9,2,0,21,21,CH
CHANDIGARH,2013,Service (Government),0,0,0,3,0,3,0,0,0,0,0,0,3,CH
CHANDIGARH,2013,Service (Private),0,10,11,6,2,29,0,0,0,0,0,0,29,CH
CHANDIGARH,2013,Public Sector Undertaking,0,0,3,0,0,3,0,0,0,0,0,0,3,CH
CHANDIGARH,2013,Student,0,8,0,0,0,8,1,14,0,0,0,15,23,CH
CHANDIGARH,2013,Unemployed,0,2,0,0,0,2,0,0,0,0,0,0,2,CH
CHANDIGARH,2013,Self-employed (Business activity),0,1,0,0,0,1,0,0,0,0,0,0,1,CH
CHANDIGARH,2013,Professional Activity,0,0,0,0,0,0,0,0,0,0,0,0,0,CH
CHANDIGARH,2013,Farming/Agriculture Activity,0,0,0,0,0,0,0,0,0,0,0,0,0,CH
CHANDIGARH,2013,Retired Person,0,0,0,0,0,0,0,0,0,0,0,0,0,CH
CHANDIGARH,2013,Total,0,28,18,11,2,59,1,26,9,2,0,38,97,CH
CHANDIGARH,2013,Total Salaried,0,10,14,9,2,35,0,0,0,0,0,0,35,CH
CHANDIGARH,2013,Total Self-employed,0,8,4,2,0,14,0,2,0,0,0,2,16,CH
CHHATTISGARH,2013,Others (Please Specify),45,913,950,553,261,2722,47,240,159,114,72,632,3354,CG
CHHATTISGARH,2013,House Wife,0,0,0,0,0,0,2,458,275,118,44,897,897,CG
CHHATTISGARH,2013,Service (Government),0,3,9,6,0,18,0,3,0,0,0,3,21,CG
CHHATTISGARH,2013,Service (Private),1,69,88,30,8,196,1,9,11,9,4,34,230,CG
CHHATTISGARH,2013,Public Sector Undertaking,0,14,14,13,0,41,0,0,0,0,0,0,41,CG
CHHATTISGARH,2013,Student,35,130,3,0,0,168,42,149,0,0,0,191,359,CG
CHHATTISGARH,2013,Unemployed,1,100,85,22,0,208,0,4,1,1,0,6,214,CG
CHHATTISGARH,2013,Self-employed (Business activity),0,14,17,8,0,39,0,0,0,0,0,0,39,CG
CHHATTISGARH,2013,Professional Activity,0,58,79,33,3,173,0,2,2,0,0,4,177,CG
CHHATTISGARH,2013,Farming/Agriculture Activity,0,0,0,0,0,0,0,0,0,0,0,0,0,CG
CHHATTISGARH,2013,Retired Person,0,0,32,32,19,83,0,0,11,8,2,21,104,CG
CHHATTISGARH,2013,Total,82,1301,1277,697,291,3648,92,865,459,250,122,1788,5436,CG
CHHATTISGARH,2013,Total Salaried,1,86,111,49,8,255,1,12,11,9,4,37,292,CG
CHHATTISGARH,2013,Total Self-employed,12,669,737,424,163,2005,14,121,90,41,22,288,2293,CG
D & N HAVELI,2013,Others (Please Specify),0,1,4,6,0,11,0,0,0,0,3,3,14,DN
D & N HAVELI,2013,House Wife,0,0,0,0,0,0,0,7,4,4,3,18,18,DN
D & N HAVELI,2013,Service (Government),0,0,0,0,0,0,0,1,1,0,0,2,2,DN
D & N HAVELI,2013,Service (Private),0,0,0,0,0,0,0,0,0,0,0,0,0,DN
D & N HAVELI,2013,Public Sector Undertaking,0,11,4,2,0,17,0,0,0,1,0,1,18,DN
D & N HAVELI,2013,Student,0,4,0,0,0,4,0,5,0,0,0,5,9,DN
D & N HAVELI,2013,Unemployed,0,8,0,0,0,8,0,0,0,0,0,0,8,DN
D & N HAVELI,2013,Self-employed (Business activity),0,0,0,0,0,0,0,0,0,0,0,0,0,DN
D & N HAVELI,2013,Professional Activity,0,0,0,0,0,0,0,0,0,0,0,0,0,DN
D & N HAVELI,2013,Farming/Agriculture Activity,0,0,4,9,2,15,0,0,0,0,0,0,15,DN
D & N HAVELI,2013,Retired Person,0,0,0,0,0,0,0,0,0,0,0,0,0,DN
D & N HAVELI,2013,Total,0,24,12,17,2,55,0,13,5,5,6,29,84,DN
D & N HAVELI,2013,Total Salaried,0,11,4,2,0,17,0,1,1,1,0,3,20,DN
D & N HAVELI,2013,Total Self-employed,0,0,4,9,2,15,0,0,0,0,0,0,15,DN
DAMAN & DIU,2013,Others (Please Specify),0,1,0,0,0,1,0,0,0,0,0,0,1,DD
DAMAN & DIU,2013,House Wife,0,0,0,0,0,0,0,4,4,2,0,10,10,DD
DAMAN & DIU,2013,Service (Government),0,0,0,1,0,1,0,0,0,0,0,0,1,DD
DAMAN & DIU,2013,Service (Private),0,6,2,2,0,10,0,1,1,1,0,3,13,DD
DAMAN & DIU,2013,Public Sector Undertaking,0,0,0,0,0,0,0,0,0,0,0,0,0,DD
DAMAN & DIU,2013,Student,0,1,0,0,0,1,0,3,0,0,0,3,4,DD
DAMAN & DIU,2013,Unemployed,0,0,0,0,0,0,0,0,0,0,0,0,0,DD
DAMAN & DIU,2013,Self-employed (Business activity),0,0,0,0,0,0,0,0,0,0,0,0,0,DD
DAMAN & DIU,2013,Professional Activity,0,0,0,0,0,0,0,0,0,0,0,0,0,DD
DAMAN & DIU,2013,Farming/Agriculture Activity,0,0,0,0,0,0,0,0,0,0,0,0,0,DD
DAMAN & DIU,2013,Retired Person,0,0,0,0,0,0,0,0,0,0,0,0,0,DD
DAMAN & DIU,2013,Total,0,8,2,3,0,13,0,8,5,3,0,16,29,DD
DAMAN & DIU,2013,Total Salaried,0,6,2,3,0,11,0,1,1,1,0,3,14,DD
DAMAN & DIU,2013,Total Self-employed,0,1,0,0,0,1,0,0,0,0,0,0,1,DD
DELHI (UT),2013,Others (Please Specify),8,222,269,99,73,671,5,98,52,12,4,171,842,DL
DELHI (UT),2013,House Wife,0,0,0,0,0,0,0,175,86,21,4,286,286,DL
DELHI (UT),2013,Service (Government),0,8,15,7,0,30,0,4,2,2,0,8,38,DL
DELHI (UT),2013,Service (Private),0,62,65,32,0,159,0,9,4,0,0,13,172,DL
DELHI (UT),2013,Public Sector Undertaking,0,20,25,8,0,53,0,8,1,0,0,9,62,DL
DELHI (UT),2013,Student,13,110,2,0,0,125,19,102,4,0,0,125,250,DL
DELHI (UT),2013,Unemployed,0,145,118,37,9,309,0,23,4,1,1,29,338,DL
DELHI (UT),2013,Self-employed (Business activity),0,14,9,11,2,36,0,0,0,0,0,0,36,DL
DELHI (UT),2013,Professional Activity,0,4,4,1,3,12,0,0,0,0,0,0,12,DL
DELHI (UT),2013,Farming/Agriculture Activity,0,3,2,2,0,7,0,1,0,0,0,1,8,DL
DELHI (UT),2013,Retired Person,0,0,1,1,13,15,0,0,0,0,0,0,15,DL
DELHI (UT),2013,Total,21,588,510,198,100,1417,24,420,153,36,9,642,2059,DL
DELHI (UT),2013,Total Salaried,0,90,105,47,0,242,0,21,7,2,0,30,272,DL
DELHI (UT),2013,Total Self-employed,0,76,107,42,12,237,0,29,7,2,2,40,277,DL
GOA,2013,Others (Please Specify),0,15,26,7,7,55,2,8,2,0,0,12,67,GA
GOA,2013,House Wife,0,0,0,0,0,0,1,17,24,7,7,56,56,GA
GOA,2013,Service (Government),0,0,2,2,0,4,0,0,2,0,0,2,6,GA
GOA,2013,Service (Private),0,27,24,8,0,59,0,3,2,0,0,5,64,GA
GOA,2013,Public Sector Undertaking,0,0,0,0,0,0,0,1,0,0,0,1,1,GA
GOA,2013,Student,0,12,0,0,0,12,2,9,0,0,0,11,23,GA
GOA,2013,Unemployed,0,20,19,23,11,73,0,8,2,0,1,11,84,GA
GOA,2013,Self-employed (Business activity),0,7,6,4,0,17,0,0,0,0,0,0,17,GA
GOA,2013,Professional Activity,0,1,2,2,0,5,0,0,0,0,0,0,5,GA
GOA,2013,Farming/Agriculture Activity,0,0,0,1,0,1,0,0,0,0,0,0,1,GA
GOA,2013,Retired Person,0,0,1,1,2,4,0,0,0,0,0,0,4,GA
GOA,2013,Total,0,82,80,48,20,230,5,46,32,7,8,98,328,GA
GOA,2013,Total Salaried,0,27,26,10,0,63,0,4,4,0,0,8,71,GA
GOA,2013,Total Self-employed,0,12,14,12,2,40,0,2,0,0,0,2,42,GA
GUJARAT,2013,Others (Please Specify),23,384,462,273,82,1224,15,160,69,36,26,306,1530,GJ
GUJARAT,2013,House Wife,0,0,0,0,0,0,3,754,575,295,105,1732,1732,GJ
GUJARAT,2013,Service (Government),0,20,58,31,0,109,0,10,7,1,0,18,127,GJ
GUJARAT,2013,Service (Private),0,228,284,145,15,672,0,48,28,12,0,88,760,GJ
GUJARAT,2013,Public Sector Undertaking,0,39,37,26,4,106,1,13,15,7,0,36,142,GJ
GUJARAT,2013,Student,19,170,8,0,0,197,20,165,4,0,0,189,386,GJ
GUJARAT,2013,Unemployed,0,173,231,117,3,524,1,23,14,5,3,46,570,GJ
GUJARAT,2013,Self-employed (Business activity),0,108,165,91,23,387,0,6,5,6,0,17,404,GJ
GUJARAT,2013,Professional Activity,1,215,237,169,32,654,0,34,8,12,2,56,710,GJ
GUJARAT,2013,Farming/Agriculture Activity,2,158,181,121,27,489,0,42,30,15,6,93,582,GJ
GUJARAT,2013,Retired Person,0,0,0,34,136,170,0,2,1,0,50,53,223,GJ
GUJARAT,2013,Total,45,1495,1663,1007,322,4532,40,1257,756,389,192,2634,7166,GJ
GUJARAT,2013,Total Salaried,0,287,379,202,19,887,1,71,50,20,0,142,1029,GJ
GUJARAT,2013,Total Self-employed,4,677,816,519,124,2140,1,130,67,42,17,257,2397,GJ
HARYANA,2013,Others (Please Specify),38,305,410,343,127,1223,33,90,67,35,26,251,1474,HR
HARYANA,2013,House Wife,0,0,0,0,0,0,0,239,112,38,12,401,401,HR
HARYANA,2013,Service (Government),0,7,12,18,0,37,0,1,2,0,0,3,40,HR
HARYANA,2013,Service (Private),1,84,112,53,4,254,0,14,13,6,0,33,287,HR
HARYANA,2013,Public Sector Undertaking,0,48,43,18,0,109,0,2,7,2,0,11,120,HR
HARYANA,2013,Student,18,97,6,0,0,121,10,44,0,1,1,56,177,HR
HARYANA,2013,Unemployed,1,111,110,63,7,292,0,8,5,5,1,19,311,HR
HARYANA,2013,Self-employed (Business activity),0,32,55,8,2,97,0,0,0,0,0,0,97,HR
HARYANA,2013,Professional Activity,0,8,12,8,1,29,0,0,0,0,0,0,29,HR
HARYANA,2013,Farming/Agriculture Activity,0,79,110,114,33,336,0,13,12,12,1,38,374,HR
HARYANA,2013,Retired Person,0,0,1,2,1,4,0,0,0,2,0,2,6,HR
HARYANA,2013,Total,58,771,871,627,175,2502,43,411,218,101,41,814,3316,HR
HARYANA,2013,Total Salaried,1,139,167,89,4,400,0,17,22,8,0,47,447,HR
HARYANA,2013,Total Self-employed,20,240,391,327,113,1091,18,58,41,30,16,163,1254,HR
HIMACHAL PRADESH,2013,Others (Please Specify),1,67,52,33,10,163,4,24,10,12,8,58,221,HP
HIMACHAL PRADESH,2013,House Wife,0,0,0,0,0,0,0,41,30,15,2,88,88,HP
HIMACHAL PRADESH,2013,Service (Government),0,1,8,9,0,18,0,0,2,0,0,2,20,HP
HIMACHAL PRADESH,2013,Service (Private),0,8,12,6,3,29,0,1,4,1,0,6,35,HP
HIMACHAL PRADESH,2013,Public Sector Undertaking,0,6,6,4,1,17,0,1,3,1,0,5,22,HP
HIMACHAL PRADESH,2013,Student,4,21,0,0,0,25,2,20,0,0,0,22,47,HP
HIMACHAL PRADESH,2013,Unemployed,0,27,22,3,1,53,0,1,2,1,0,4,57,HP
HIMACHAL PRADESH,2013,Self-employed (Business activity),0,4,7,3,1,15,0,1,0,1,0,2,17,HP
HIMACHAL PRADESH,2013,Professional Activity,0,2,2,2,1,7,0,1,1,0,0,2,9,HP
HIMACHAL PRADESH,2013,Farming/Agriculture Activity,0,6,13,11,2,32,0,0,1,0,0,1,33,HP
HIMACHAL PRADESH,2013,Retired Person,0,0,0,0,5,5,0,0,0,0,0,0,5,HP
HIMACHAL PRADESH,2013,Total,5,142,122,71,24,364,6,90,53,31,10,190,554,HP
HIMACHAL PRADESH,2013,Total Salaried,0,15,26,19,4,64,0,2,9,2,0,13,77,HP
HIMACHAL PRADESH,2013,Total Self-employed,0,34,43,23,8,108,0,8,3,3,2,16,124,HP
JAMMU & KASHMIR,2013,Others (Please Specify),0,12,34,23,4,73,2,24,6,3,0,35,108,JK
JAMMU & KASHMIR,2013,House Wife,0,0,0,0,0,0,0,17,43,6,5,71,71,JK
JAMMU & KASHMIR,2013,Service (Government),0,4,5,6,0,15,0,0,0,0,0,0,15,JK
JAMMU & KASHMIR,2013,Service (Private),0,1,0,4,2,7,0,0,0,0,0,0,7,JK
JAMMU & KASHMIR,2013,Public Sector Undertaking,0,0,3,2,5,10,0,0,0,0,0,0,10,JK
JAMMU & KASHMIR,2013,Student,1,13,0,0,0,14,1,14,0,0,0,15,29,JK
JAMMU & KASHMIR,2013,Unemployed,0,5,12,1,0,18,0,10,3,0,0,13,31,JK
JAMMU & KASHMIR,2013,Self-employed (Business activity),0,0,6,2,3,11,0,0,0,0,0,0,11,JK
JAMMU & KASHMIR,2013,Professional Activity,0,0,2,0,0,2,0,0,0,0,0,0,2,JK
JAMMU & KASHMIR,2013,Farming/Agriculture Activity,0,3,7,6,2,18,0,0,0,0,0,0,18,JK
JAMMU & KASHMIR,2013,Retired Person,0,0,0,0,0,0,0,0,0,0,0,0,0,JK
JAMMU & KASHMIR,2013,Total,1,38,69,44,16,168,3,65,52,9,5,134,302,JK
JAMMU & KASHMIR,2013,Total Salaried,0,5,8,12,7,32,0,0,0,0,0,0,32,JK
JAMMU & KASHMIR,2013,Total Self-employed,0,9,42,30,9,90,2,23,5,1,0,31,121,JK
JHARKHAND,2013,Others (Please Specify),43,120,121,100,53,437,14,70,44,44,13,185,622,JH
JHARKHAND,2013,House Wife,0,0,0,0,0,0,0,70,90,29,4,193,193,JH
JHARKHAND,2013,Service (Government),0,4,7,4,0,15,0,0,1,0,0,1,16,JH
JHARKHAND,2013,Service (Private),0,34,44,24,2,104,0,2,8,1,0,11,115,JH
JHARKHAND,2013,Public Sector Undertaking,0,3,3,6,1,13,0,7,0,0,0,7,20,JH
JHARKHAND,2013,Student,7,84,8,0,0,99,8,41,2,0,0,51,150,JH
JHARKHAND,2013,Unemployed,0,35,51,33,6,125,0,10,1,3,0,14,139,JH
JHARKHAND,2013,Self-employed (Business activity),0,3,16,13,3,35,0,1,0,0,0,1,36,JH
JHARKHAND,2013,Professional Activity,0,5,11,0,2,18,0,3,3,0,0,6,24,JH
JHARKHAND,2013,Farming/Agriculture Activity,0,30,34,69,2,135,0,2,2,3,0,7,142,JH
JHARKHAND,2013,Retired Person,0,0,0,0,3,3,0,0,0,0,0,0,3,JH
JHARKHAND,2013,Total,50,318,295,249,72,984,22,206,151,80,17,476,1460,JH
JHARKHAND,2013,Total Salaried,0,41,54,34,3,132,0,9,9,1,0,19,151,JH
JHARKHAND,2013,Total Self-employed,0,66,86,100,19,271,0,27,15,9,1,52,323,JH
KARNATAKA,2013,Others (Please Specify),47,889,1333,866,291,3426,56,282,332,204,85,959,4385,KA
KARNATAKA,2013,House Wife,0,0,0,0,0,0,3,703,583,258,127,1674,1674,KA
KARNATAKA,2013,Service (Government),0,31,66,67,19,183,0,29,13,6,4,52,235,KA
KARNATAKA,2013,Service (Private),0,307,339,204,37,887,0,105,54,23,4,186,1073,KA
KARNATAKA,2013,Public Sector Undertaking,0,45,52,48,14,159,0,20,11,8,6,45,204,KA
KARNATAKA,2013,Student,59,283,27,7,10,386,46,224,4,8,4,286,672,KA
KARNATAKA,2013,Unemployed,3,226,265,136,60,690,2,59,16,8,5,90,780,KA
KARNATAKA,2013,Self-employed (Business activity),0,134,213,145,32,524,3,9,27,14,4,57,581,KA
KARNATAKA,2013,Professional Activity,3,64,59,58,19,203,0,2,4,3,1,10,213,KA
KARNATAKA,2013,Farming/Agriculture Activity,0,220,461,374,177,1232,3,38,49,43,38,171,1403,KA
KARNATAKA,2013,Retired Person,0,0,0,2,41,43,0,0,0,0,3,3,46,KA
KARNATAKA,2013,Total,112,2199,2815,1907,700,7733,113,1471,1093,575,281,3533,11266,KA
KARNATAKA,2013,Total Salaried,0,383,457,319,70,1229,0,154,78,37,14,283,1512,KA
KARNATAKA,2013,Total Self-employed,22,997,1718,1166,410,4313,48,220,259,183,77,787,5100,KA
KERALA,2013,Others (Please Specify),0,639,1055,1138,726,3558,0,106,56,72,106,340,3898,KL
KERALA,2013,House Wife,0,0,0,0,0,0,0,196,326,302,221,1045,1045,KL
KERALA,2013,Service (Government),0,10,28,29,17,84,0,4,7,10,11,32,116,KL
KERALA,2013,Service (Private),0,122,221,199,38,580,0,21,28,11,4,64,644,KL
KERALA,2013,Public Sector Undertaking,0,4,40,35,2,81,0,2,7,10,1,20,101,KL
KERALA,2013,Student,38,82,6,8,0,134,43,122,2,0,0,167,301,KL
KERALA,2013,Unemployed,0,87,249,191,120,647,0,37,37,24,31,129,776,KL
KERALA,2013,Self-employed (Business activity),0,49,169,149,67,434,0,4,6,4,1,15,449,KL
KERALA,2013,Professional Activity,0,37,61,75,14,187,0,5,7,6,1,19,206,KL
KERALA,2013,Farming/Agriculture Activity,0,94,243,341,204,882,0,27,15,17,31,90,972,KL
KERALA,2013,Retired Person,0,0,1,27,86,114,0,0,0,7,17,24,138,KL
KERALA,2013,Total,38,1124,2073,2192,1274,6701,43,524,491,463,424,1945,8646,KL
KERALA,2013,Total Salaried,0,136,289,263,57,745,0,27,42,31,16,116,861,KL
KERALA,2013,Total Self-employed,0,651,1249,1361,787,4048,0,119,77,76,117,389,4437,KL
LAKSHADWEEP,2013,Others (Please Specify),0,0,0,0,1,1,0,0,0,0,0,0,1,LD
LAKSHADWEEP,2013,House Wife,0,0,0,0,0,0,0,0,1,0,0,1,1,LD
LAKSHADWEEP,2013,Service (Government),0,0,0,0,0,0,0,0,0,0,0,0,0,LD
LAKSHADWEEP,2013,Service (Private),0,0,0,0,0,0,0,0,0,0,0,0,0,LD
LAKSHADWEEP,2013,Public Sector Undertaking,0,0,0,0,0,0,0,0,0,0,0,0,0,LD
LAKSHADWEEP,2013,Student,0,0,0,0,0,0,0,0,0,0,0,0,0,LD
LAKSHADWEEP,2013,Unemployed,0,0,0,0,0,0,0,1,0,0,0,1,1,LD
LAKSHADWEEP,2013,Self-employed (Business activity),0,0,0,0,0,0,0,0,0,0,0,0,0,LD
LAKSHADWEEP,2013,Professional Activity,0,0,0,0,0,0,0,0,0,0,0,0,0,LD
LAKSHADWEEP,2013,Farming/Agriculture Activity,0,0,0,0,0,0,0,0,0,0,0,0,0,LD
LAKSHADWEEP,2013,Retired Person,0,0,0,0,0,0,0,0,0,0,0,0,0,LD
LAKSHADWEEP,2013,Total,0,0,0,0,1,1,0,1,1,0,0,2,3,LD
LAKSHADWEEP,2013,Total Salaried,0,0,0,0,0,0,0,0,0,0,0,0,0,LD
LAKSHADWEEP,2013,Total Self-employed,0,0,0,0,0,0,0,0,0,0,0,0,0,LD
MADHYA PRADESH,2013,Others (Please Specify),104,853,790,492,268,2507,83,347,185,99,28,742,3249,MP
MADHYA PRADESH,2013,House Wife,0,0,0,0,0,0,9,1300,704,229,133,2375,2375,MP
MADHYA PRADESH,2013,Service (Government),0,31,37,24,1,93,0,5,6,3,1,15,108,MP
MADHYA PRADESH,2013,Service (Private),0,223,250,111,18,602,0,37,35,9,2,83,685,MP
MADHYA PRADESH,2013,Public Sector Undertaking,0,30,41,18,8,97,0,13,3,2,1,19,116,MP
MADHYA PRADESH,2013,Student,77,251,28,0,1,357,66,239,2,3,0,310,667,MP
MADHYA PRADESH,2013,Unemployed,5,140,95,59,23,322,0,18,8,7,2,35,357,MP
MADHYA PRADESH,2013,Self-employed (Business activity),0,126,132,87,27,372,0,4,3,3,1,11,383,MP
MADHYA PRADESH,2013,Professional Activity,0,97,111,59,34,301,0,23,28,14,6,71,372,MP
MADHYA PRADESH,2013,Farming/Agriculture Activity,5,312,349,232,99,997,0,42,35,12,4,93,1090,MP
MADHYA PRADESH,2013,Retired Person,0,0,1,0,21,22,0,20,2,0,0,22,44,MP
MADHYA PRADESH,2013,Total,191,2063,1834,1082,500,5670,158,2048,1011,381,178,3776,9446,MP
MADHYA PRADESH,2013,Total Salaried,0,284,328,153,27,792,0,55,44,14,4,117,909,MP
MADHYA PRADESH,2013,Total Self-employed,67,1147,1133,709,333,3389,28,249,157,64,26,524,3913,MP
MAHARASHTRA,2013,Others (Please Specify),14,1041,1408,896,431,3790,14,156,119,63,28,380,4170,MH
MAHARASHTRA,2013,House Wife,0,0,0,0,0,0,0,1539,1110,415,284,3348,3348,MH
MAHARASHTRA,2013,Service (Government),0,37,87,76,2,202,0,17,11,1,0,29,231,MH
MAHARASHTRA,2013,Service (Private),0,720,850,481,99,2150,0,81,34,19,0,134,2284,MH
MAHARASHTRA,2013,Public Sector Undertaking,0,34,61,45,11,151,0,4,2,2,0,8,159,MH
MAHARASHTRA,2013,Student,75,474,16,1,0,566,92,479,2,2,0,575,1141,MH
MAHARASHTRA,2013,Unemployed,1,397,369,144,36,947,0,60,6,2,1,69,1016,MH
MAHARASHTRA,2013,Self-employed (Business activity),0,112,263,112,30,517,0,7,29,1,1,38,555,MH
MAHARASHTRA,2013,Professional Activity,0,117,156,101,35,409,0,4,9,5,3,21,430,MH
MAHARASHTRA,2013,Farming/Agriculture Activity,1,629,1157,841,392,3020,0,38,41,34,13,126,3146,MH
MAHARASHTRA,2013,Retired Person,0,0,0,13,127,140,0,0,0,0,2,2,142,MH
MAHARASHTRA,2013,Total,91,3561,4367,2710,1163,11892,106,2385,1363,544,332,4730,16622,MH
MAHARASHTRA,2013,Total Salaried,0,791,998,602,112,2503,0,102,47,22,0,171,2674,MH
MAHARASHTRA,2013,Total Self-employed,8,1751,2736,1792,821,7108,8,183,153,76,42,462,7570,MH
MANIPUR,2013,Others (Please Specify),0,6,3,2,0,11,1,0,1,0,0,2,13,MN
MANIPUR,2013,House Wife,0,0,0,0,0,0,0,7,1,1,0,9,9,MN
MANIPUR,2013,Service (Government),0,1,4,0,0,5,0,1,0,0,0,1,6,MN
MANIPUR,2013,Service (Private),0,0,0,0,0,0,0,0,0,0,0,0,0,MN
MANIPUR,2013,Public Sector Undertaking,0,0,0,0,0,0,0,0,0,0,0,0,0,MN
MANIPUR,2013,Student,1,0,0,0,0,1,1,2,0,0,0,3,4,MN
MANIPUR,2013,Unemployed,0,0,2,1,1,4,0,0,0,0,0,0,4,MN
MANIPUR,2013,Self-employed (Business activity),0,0,0,0,0,0,0,0,0,0,0,0,0,MN
MANIPUR,2013,Professional Activity,0,0,0,0,0,0,0,0,0,0,0,0,0,MN
MANIPUR,2013,Farming/Agriculture Activity,0,0,1,0,0,1,0,0,0,0,0,0,1,MN
MANIPUR,2013,Retired Person,0,0,0,0,0,0,0,0,0,0,0,0,0,MN
MANIPUR,2013,Total,1,7,10,3,1,22,2,10,2,1,0,15,37,MN
MANIPUR,2013,Total Salaried,0,1,4,0,0,5,0,1,0,0,0,1,6,MN
MANIPUR,2013,Total Self-employed,0,0,1,0,0,1,0,0,0,0,0,0,1,MN
MEGHALAYA,2013,Others (Please Specify),2,11,4,1,0,18,0,3,0,1,0,4,22,ML
MEGHALAYA,2013,House Wife,0,0,0,0,0,0,0,7,9,1,0,17,17,ML
MEGHALAYA,2013,Service (Government),0,0,5,2,0,7,0,0,0,0,0,0,7,ML
MEGHALAYA,2013,Service (Private),0,5,3,2,0,10,0,0,0,0,0,0,10,ML
MEGHALAYA,2013,Public Sector Undertaking,0,0,0,0,2,2,0,0,0,0,0,0,2,ML
MEGHALAYA,2013,Student,1,13,0,0,0,14,6,10,0,0,0,16,30,ML
MEGHALAYA,2013,Unemployed,0,20,9,1,1,31,0,2,0,0,0,2,33,ML
MEGHALAYA,2013,Self-employed (Business activity),0,2,4,4,0,10,0,1,0,0,0,1,11,ML
MEGHALAYA,2013,Professional Activity,0,0,0,0,0,0,0,0,0,0,0,0,0,ML
MEGHALAYA,2013,Farming/Agriculture Activity,0,0,3,1,0,4,0,1,0,0,0,1,5,ML
MEGHALAYA,2013,Retired Person,0,0,0,0,0,0,0,0,0,0,0,0,0,ML
MEGHALAYA,2013,Total,3,51,28,11,3,96,6,24,9,2,0,41,137,ML
MEGHALAYA,2013,Total Salaried,0,5,8,4,2,19,0,0,0,0,0,0,19,ML
MEGHALAYA,2013,Total Self-employed,0,8,8,5,0,21,0,2,0,0,0,2,23,ML
MIZORAM,2013,Others (Please Specify),2,5,2,1,0,10,2,3,0,2,0,7,17,MZ
MIZORAM,2013,House Wife,0,0,0,0,0,0,0,1,3,1,0,5,5,MZ
MIZORAM,2013,Service (Government),0,3,2,1,0,6,0,0,0,0,0,0,6,MZ
MIZORAM,2013,Service (Private),0,4,1,2,0,7,0,0,0,0,0,0,7,MZ
MIZORAM,2013,Public Sector Undertaking,0,0,0,0,0,0,0,0,0,0,0,0,0,MZ
MIZORAM,2013,Student,1,5,0,0,0,6,0,2,0,0,0,2,8,MZ
MIZORAM,2013,Unemployed,0,23,11,4,0,38,0,1,1,0,0,2,40,MZ
MIZORAM,2013,Self-employed (Business activity),0,3,0,1,0,4,0,0,0,0,0,0,4,MZ
MIZORAM,2013,Professional Activity,0,0,0,1,0,1,0,0,0,0,0,0,1,MZ
MIZORAM,2013,Farming/Agriculture Activity,0,1,4,1,0,6,0,0,0,0,0,0,6,MZ
MIZORAM,2013,Retired Person,0,0,0,0,1,1,0,0,0,0,0,0,1,MZ
MIZORAM,2013,Total,3,44,20,11,1,79,2,7,4,3,0,16,95,MZ
MIZORAM,2013,Total Salaried,0,7,3,3,0,13,0,0,0,0,0,0,13,MZ
MIZORAM,2013,Total Self-employed,1,6,6,4,0,17,2,1,0,0,0,3,20,MZ
NAGALAND,2013,Others (Please Specify),0,2,8,1,0,11,0,1,2,0,0,3,14,NG
NAGALAND,2013,House Wife,0,0,0,0,0,0,0,3,0,1,2,6,6,NG
NAGALAND,2013,Service (Government),0,0,4,0,0,4,0,0,0,0,0,0,4,NG
NAGALAND,2013,Service (Private),0,0,0,0,0,0,0,0,0,0,0,0,0,NG
NAGALAND,2013,Public Sector Undertaking,0,0,0,0,0,0,0,0,0,0,0,0,0,NG
NAGALAND,2013,Student,1,2,0,0,0,3,0,3,0,0,0,3,6,NG
NAGALAND,2013,Unemployed,0,0,2,0,0,2,0,0,0,0,0,0,2,NG
NAGALAND,2013,Self-employed (Business activity),0,1,0,0,0,1,0,0,0,0,0,0,1,NG
NAGALAND,2013,Professional Activity,0,2,0,0,0,2,0,0,0,0,0,0,2,NG
NAGALAND,2013,Farming/Agriculture Activity,0,0,1,0,1,2,0,0,0,0,0,0,2,NG
NAGALAND,2013,Retired Person,0,0,0,0,0,0,0,0,0,0,0,0,0,NG
NAGALAND,2013,Total,1,7,15,1,1,25,0,7,2,1,2,12,37,NG
NAGALAND,2013,Total Salaried,0,0,4,0,0,4,0,0,0,0,0,0,4,NG
NAGALAND,2013,Total Self-employed,0,5,9,1,1,16,0,1,2,0,0,3,19,NG
ODISHA,2013,Others (Please Specify),123,444,466,427,250,1710,107,268,247,157,64,843,2553,OD
ODISHA,2013,House Wife,0,0,0,0,0,0,0,236,261,137,51,685,685,OD
ODISHA,2013,Service (Government),0,13,41,16,3,73,0,5,8,7,0,20,93,OD
ODISHA,2013,Service (Private),0,98,148,80,32,358,2,32,47,15,8,104,462,OD
ODISHA,2013,Public Sector Undertaking,0,35,42,36,5,118,0,9,17,8,0,34,152,OD
ODISHA,2013,Student,30,143,0,0,0,173,30,110,0,0,0,140,313,OD
ODISHA,2013,Unemployed,0,129,139,58,21,347,0,54,31,8,0,93,440,OD
ODISHA,2013,Self-employed (Business activity),0,53,134,84,30,301,0,16,18,13,0,47,348,OD
ODISHA,2013,Professional Activity,0,5,12,18,1,36,0,0,2,1,0,3,39,OD
ODISHA,2013,Farming/Agriculture Activity,0,18,58,51,16,143,0,2,1,2,2,7,150,OD
ODISHA,2013,Retired Person,0,0,0,0,13,13,0,0,0,0,4,4,17,OD
ODISHA,2013,Total,153,938,1040,770,371,3272,139,732,632,348,129,1980,5252,OD
ODISHA,2013,Total Salaried,0,146,231,132,40,549,2,46,72,30,8,158,707,OD
ODISHA,2013,Total Self-employed,43,263,412,384,231,1333,77,180,163,106,54,580,1913,OD
PUDUCHERRY,2013,Others (Please Specify),0,18,48,63,8,137,0,0,1,0,0,1,138,PY
PUDUCHERRY,2013,House Wife,0,0,0,0,0,0,0,26,34,10,18,88,88,PY
PUDUCHERRY,2013,Service (Government),0,5,4,15,0,24,0,0,0,1,0,1,25,PY
PUDUCHERRY,2013,Service (Private),0,14,12,4,4,34,0,10,2,0,0,12,46,PY
PUDUCHERRY,2013,Public Sector Undertaking,0,0,1,0,0,1,0,0,0,0,0,0,1,PY
PUDUCHERRY,2013,Student,3,9,0,0,0,12,2,23,1,0,0,26,38,PY
PUDUCHERRY,2013,Unemployed,0,13,11,22,20,66,0,4,0,1,0,5,71,PY
PUDUCHERRY,2013,Self-employed (Business activity),0,25,56,44,3,128,0,3,2,0,0,5,133,PY
PUDUCHERRY,2013,Professional Activity,0,0,0,0,0,0,0,0,0,0,0,0,0,PY
PUDUCHERRY,2013,Farming/Agriculture Activity,0,0,0,0,0,0,0,0,0,0,0,0,0,PY
PUDUCHERRY,2013,Retired Person,0,0,0,2,4,6,0,0,0,0,0,0,6,PY
PUDUCHERRY,2013,Total,3,84,132,150,39,408,2,66,40,12,18,138,546,PY
PUDUCHERRY,2013,Total Salaried,0,19,17,19,4,59,0,10,2,1,0,13,72,PY
PUDUCHERRY,2013,Total Self-employed,0,43,104,107,11,265,0,3,3,0,0,6,271,PY
PUNJAB,2013,Others (Please Specify),2,100,90,57,35,284,4,22,9,2,1,38,322,PN
PUNJAB,2013,House Wife,0,0,0,0,0,0,0,73,50,22,11,156,156,PN
PUNJAB,2013,Service (Government),0,5,13,5,0,23,0,1,3,0,0,4,27,PN
PUNJAB,2013,Service (Private),0,55,40,24,6,125,0,11,0,0,0,11,136,PN
PUNJAB,2013,Public Sector Undertaking,0,5,2,0,0,7,0,1,0,0,0,1,8,PN
PUNJAB,2013,Student,4,37,1,0,0,42,2,31,0,0,0,33,75,PN
PUNJAB,2013,Unemployed,0,44,24,6,6,80,0,9,1,2,0,12,92,PN
PUNJAB,2013,Self-employed (Business activity),0,6,15,12,1,34,0,0,0,0,0,0,34,PN
PUNJAB,2013,Professional Activity,0,7,8,9,0,24,0,1,0,0,0,1,25,PN
PUNJAB,2013,Farming/Agriculture Activity,0,33,30,15,5,83,0,0,0,0,0,0,83,PN
PUNJAB,2013,Retired Person,0,0,1,3,7,11,0,2,0,1,0,3,14,PN
PUNJAB,2013,Total,6,292,224,131,60,713,6,151,63,27,12,259,972,PN
PUNJAB,2013,Total Salaried,0,65,55,29,6,155,0,13,3,0,0,16,171,PN
PUNJAB,2013,Total Self-employed,0,104,114,69,29,316,2,10,3,2,0,17,333,PN
RAJASTHAN,2013,Others (Please Specify),27,618,784,521,111,2061,15,126,173,144,15,473,2534,RJ
RAJASTHAN,2013,House Wife,0,0,0,0,0,0,2,353,281,109,42,787,787,RJ
RAJASTHAN,2013,Service (Government),0,13,16,10,1,40,0,3,1,0,1,5,45,RJ
RAJASTHAN,2013,Service (Private),0,162,166,83,5,416,0,11,13,4,2,30,446,RJ
RAJASTHAN,2013,Public Sector Undertaking,0,7,5,3,0,15,0,1,3,0,0,4,19,RJ
RAJASTHAN,2013,Student,20,117,9,0,0,146,10,88,12,0,0,110,256,RJ
RAJASTHAN,2013,Unemployed,0,58,83,33,7,181,0,11,14,7,2,34,215,RJ
RAJASTHAN,2013,Self-employed (Business activity),0,32,88,36,4,160,0,5,7,2,0,14,174,RJ
RAJASTHAN,2013,Professional Activity,0,11,40,29,1,81,0,0,1,0,0,1,82,RJ
RAJASTHAN,2013,Farming/Agriculture Activity,0,96,99,56,16,267,0,14,9,2,0,25,292,RJ
RAJASTHAN,2013,Retired Person,0,0,1,3,6,10,0,0,0,0,0,0,10,RJ
RAJASTHAN,2013,Total,47,1114,1291,774,151,3377,27,612,514,268,62,1483,4860,RJ
RAJASTHAN,2013,Total Salaried,0,182,187,96,6,471,0,15,17,4,3,39,510,RJ
RAJASTHAN,2013,Total Self-employed,0,451,664,377,64,1556,1,62,103,93,2,261,1817,RJ
SIKKIM,2013,Others (Please Specify),2,2,0,0,0,4,1,0,0,0,0,1,5,SK
SIKKIM,2013,House Wife,0,0,0,0,0,0,0,5,3,1,0,9,9,SK
SIKKIM,2013,Service (Government),0,2,4,3,0,9,0,2,1,0,0,3,12,SK
SIKKIM,2013,Service (Private),0,6,7,2,2,17,0,4,3,2,0,9,26,SK
SIKKIM,2013,Public Sector Undertaking,0,3,11,2,0,16,0,0,2,0,0,2,18,SK
SIKKIM,2013,Student,3,3,0,0,0,6,2,3,0,0,0,5,11,SK
SIKKIM,2013,Unemployed,0,7,5,1,0,13,0,7,0,0,0,7,20,SK
SIKKIM,2013,Self-employed (Business activity),0,17,14,3,0,34,0,6,0,0,0,6,40,SK
SIKKIM,2013,Professional Activity,0,0,2,1,0,3,0,2,0,0,0,2,5,SK
SIKKIM,2013,Farming/Agriculture Activity,0,9,5,4,3,21,0,8,2,2,2,14,35,SK
SIKKIM,2013,Retired Person,0,0,0,0,2,2,0,0,0,0,1,1,3,SK
SIKKIM,2013,Total,5,49,48,16,7,125,3,37,11,5,3,59,184,SK
SIKKIM,2013,Total Salaried,0,11,22,7,2,42,0,6,6,2,0,14,56,SK
SIKKIM,2013,Total Self-employed,0,28,21,8,3,60,0,16,2,2,2,22,82,SK
TAMIL NADU,2013,Others (Please Specify),94,1280,2068,1630,909,5981,79,670,480,303,163,1695,7676,TN
TAMIL NADU,2013,House Wife,0,0,0,0,0,0,0,993,924,435,244,2596,2596,TN
TAMIL NADU,2013,Service (Government),0,26,73,63,0,162,0,12,9,11,0,32,194,TN
TAMIL NADU,2013,Service (Private),0,343,582,424,94,1443,0,133,70,39,9,251,1694,TN
TAMIL NADU,2013,Public Sector Undertaking,0,54,65,64,16,199,0,16,17,9,1,43,242,TN
TAMIL NADU,2013,Student,96,384,17,0,0,497,76,282,11,0,0,369,866,TN
TAMIL NADU,2013,Unemployed,0,400,382,332,98,1212,0,139,77,63,18,297,1509,TN
TAMIL NADU,2013,Self-employed (Business activity),0,220,372,340,68,1000,0,20,23,16,3,62,1062,TN
TAMIL NADU,2013,Professional Activity,0,97,233,128,32,490,0,17,19,12,3,51,541,TN
TAMIL NADU,2013,Farming/Agriculture Activity,0,12,24,43,17,96,0,4,3,2,0,9,105,TN
TAMIL NADU,2013,Retired Person,0,0,0,22,80,102,0,0,0,0,14,14,116,TN
TAMIL NADU,2013,Total,190,2816,3816,3046,1314,11182,155,2286,1633,890,455,5419,16601,TN
TAMIL NADU,2013,Total Salaried,0,423,720,551,110,1804,0,161,96,59,10,326,2130,TN
TAMIL NADU,2013,Total Self-employed,21,880,1648,1288,545,4382,5,179,195,92,43,514,4896,TN
TRIPURA,2013,Others (Please Specify),16,114,124,80,24,358,19,27,22,17,20,105,463,TR
TRIPURA,2013,House Wife,0,0,0,0,0,0,0,72,44,34,13,163,163,TR
TRIPURA,2013,Service (Government),0,1,3,0,0,4,0,0,0,0,0,0,4,TR
TRIPURA,2013,Service (Private),0,2,2,0,0,4,0,0,0,0,0,0,4,TR
TRIPURA,2013,Public Sector Undertaking,0,0,1,0,0,1,0,0,0,0,0,0,1,TR
TRIPURA,2013,Student,8,71,5,0,0,84,4,42,0,0,0,46,130,TR
TRIPURA,2013,Unemployed,0,20,31,5,1,57,0,6,2,1,0,9,66,TR
TRIPURA,2013,Self-employed (Business activity),0,2,34,26,10,72,0,1,1,0,0,2,74,TR
TRIPURA,2013,Professional Activity,0,0,0,0,0,0,0,0,0,0,0,0,0,TR
TRIPURA,2013,Farming/Agriculture Activity,0,4,17,24,11,56,0,0,0,0,0,0,56,TR
TRIPURA,2013,Retired Person,0,0,0,0,0,0,0,0,0,0,0,0,0,TR
TRIPURA,2013,Total,24,214,217,135,46,636,23,148,69,52,33,325,961,TR
TRIPURA,2013,Total Salaried,0,3,6,0,0,9,0,0,0,0,0,0,9,TR
TRIPURA,2013,Total Self-employed,0,6,51,50,21,128,0,1,1,0,0,2,130,TR
UTTAR PRADESH,2013,Others (Please Specify),63,253,397,245,114,1072,29,197,105,67,10,408,1480,UP
UTTAR PRADESH,2013,House Wife,0,0,0,0,0,0,5,605,375,145,40,1170,1170,UP
UTTAR PRADESH,2013,Service (Government),0,8,22,13,2,45,0,11,5,2,0,18,63,UP
UTTAR PRADESH,2013,Service (Private),0,151,186,97,12,446,0,67,39,20,1,127,573,UP
UTTAR PRADESH,2013,Public Sector Undertaking,0,36,31,19,4,90,1,10,6,4,1,22,112,UP
UTTAR PRADESH,2013,Student,41,154,26,6,0,227,20,149,7,2,0,178,405,UP
UTTAR PRADESH,2013,Unemployed,3,111,100,83,16,313,2,16,22,17,0,57,370,UP
UTTAR PRADESH,2013,Self-employed (Business activity),0,83,98,57,11,249,0,9,9,3,0,21,270,UP
UTTAR PRADESH,2013,Professional Activity,0,26,29,13,0,68,0,4,3,0,0,7,75,UP
UTTAR PRADESH,2013,Farming/Agriculture Activity,5,215,235,156,33,644,5,39,49,11,2,106,750,UP
UTTAR PRADESH,2013,Retired Person,0,0,2,0,7,9,0,0,5,1,3,9,18,UP
UTTAR PRADESH,2013,Total,112,1037,1126,689,199,3163,62,1107,625,272,57,2123,5286,UP
UTTAR PRADESH,2013,Total Salaried,0,195,239,129,18,581,1,88,50,26,2,167,748,UP
UTTAR PRADESH,2013,Total Self-employed,12,432,513,315,70,1342,11,124,97,49,4,285,1627,UP
UTTARAKHAND,2013,Others (Please Specify),4,27,51,19,7,108,7,26,29,3,2,67,175,UK
UTTARAKHAND,2013,House Wife,0,0,0,0,0,0,0,14,9,10,1,34,34,UK
UTTARAKHAND,2013,Service (Government),0,5,4,4,1,14,0,0,0,0,0,0,14,UK
UTTARAKHAND,2013,Service (Private),0,12,15,5,1,33,0,2,0,0,0,2,35,UK
UTTARAKHAND,2013,Public Sector Undertaking,0,4,3,1,0,8,0,0,0,0,0,0,8,UK
UTTARAKHAND,2013,Student,0,24,0,1,0,25,0,15,0,0,0,15,40,UK
UTTARAKHAND,2013,Unemployed,0,16,5,4,0,25,0,2,0,0,0,2,27,UK
UTTARAKHAND,2013,Self-employed (Business activity),0,2,8,3,0,13,0,0,0,0,0,0,13,UK
UTTARAKHAND,2013,Professional Activity,0,0,0,0,0,0,0,0,0,0,0,0,0,UK
UTTARAKHAND,2013,Farming/Agriculture Activity,0,4,6,4,0,14,0,0,1,0,0,1,15,UK
UTTARAKHAND,2013,Retired Person,0,0,0,2,2,4,0,0,0,0,0,0,4,UK
UTTARAKHAND,2013,Total,4,94,92,43,11,244,7,59,39,13,3,121,365,UK
UTTARAKHAND,2013,Total Salaried,0,21,22,10,2,55,0,2,0,0,0,2,57,UK
UTTARAKHAND,2013,Total Self-employed,0,20,20,14,0,54,2,1,2,0,1,6,60,UK
WEST BENGAL,2013,Others (Please Specify),104,1229,1589,1124,321,4367,53,749,754,359,101,2016,6383,WB
WEST BENGAL,2013,House Wife,0,0,0,0,0,0,0,740,847,399,117,2103,2103,WB
WEST BENGAL,2013,Service (Government),0,13,29,36,3,81,0,2,2,1,0,5,86,WB
WEST BENGAL,2013,Service (Private),0,105,263,206,8,582,0,36,50,33,0,119,701,WB
WEST BENGAL,2013,Public Sector Undertaking,0,115,164,67,8,354,0,28,27,15,2,72,426,WB
WEST BENGAL,2013,Student,79,357,28,0,0,464,49,257,18,0,0,324,788,WB
WEST BENGAL,2013,Unemployed,1,249,326,191,31,798,12,129,169,71,15,396,1194,WB
WEST BENGAL,2013,Self-employed (Business activity),0,180,406,239,48,873,0,62,55,9,0,126,999,WB
WEST BENGAL,2013,Professional Activity,0,42,142,84,6,274,0,11,7,7,1,26,300,WB
WEST BENGAL,2013,Farming/Agriculture Activity,0,0,0,0,0,0,0,0,0,0,0,0,0,WB
WEST BENGAL,2013,Retired Person,0,0,0,5,62,67,0,0,0,0,8,8,75,WB
WEST BENGAL,2013,Total,184,2290,2947,1952,487,7860,114,2014,1929,894,244,5195,13055,WB
WEST BENGAL,2013,Total Salaried,0,233,456,309,19,1017,0,66,79,49,2,196,1213,WB
WEST BENGAL,2013,Total Self-employed,34,611,1107,665,121,2538,19,316,239,84,20,678,3216,WB
